25 25
21 21 21 21 21 21 21 21 21 21 21 21 21 21 21 21 21 21 21 21 21 21 21 21 21
21 21 21 21 21 21 21 21 21 21 21 21 21 21 21 21 21 21 21 21 21 21 21 21 21
21 21 21 21 21 21 21 21 19 19 19 19 19 19 19 19 19 21 21 21 21 21 21 21 21
21 21 21 21 21 21 21 21 19 19 4 19 19 19 3 19 19 21 21 21 21 21 21 21 21
21 21 21 21 21 21 21 19 19 19 19 19 19 19 19 19 19 19 21 21 21 21 21 21 21
21 21 21 21 21 21 21 19 19 19 19 16 19 15 19 19 19 19 21 21 21 21 21 21 21
21 21 21 21 21 21 21 19 10 19 19 19 19 19 19 19 11 19 21 21 21 21 21 21 21
21 21 21 21 21 21 21 19 19 19 19 19 19 19 19 19 19 19 21 21 21 21 21 21 21
18 18 18 18 18 18 18 22 22 22 22 22 22 22 22 22 22 22 18 18 18 18 18 18 18
18 18 18 18 18 18 18 22 22 22 22 22 22 22 22 22 22 22 18 18 18 18 18 18 18
18 18 18 18 18 18 18 22 22 22 22 22 22 22 22 22 22 22 18 18 18 18 18 18 18
18 18 18 18 18 18 18 22 22 22 22 22 22 22 22 22 22 22 18 18 18 18 18 18 18
18 18 18 18 18 18 18 22 22 22 22 22 22 22 22 22 22 22 18 18 18 18 18 18 18
18 18 18 18 18 18 18 22 22 22 22 22 22 22 22 22 22 22 18 18 18 18 18 18 18
18 18 18 18 18 18 18 21 21 21 21 21 21 21 21 21 21 21 18 18 18 18 18 18 18
18 18 18 18 18 18 18 21 21 21 21 21 21 21 21 21 21 21 18 18 18 18 18 18 18
18 18 18 18 18 18 18 21 21 21 21 21 21 21 21 21 21 21 18 18 18 18 18 18 18
18 18 18 18 18 18 18 21 21 21 21 21 21 21 21 21 21 21 18 18 18 18 18 18 18
18 18 18 18 18 18 18 21 21 21 21 21 21 21 21 21 21 21 18 18 18 18 18 18 18
18 18 18 18 18 18 18 21 21 21 21 21 21 21 21 21 21 21 18 18 18 18 18 18 18
18 18 18 18 18 18 18 21 21 21 21 21 21 21 21 21 21 21 18 18 18 18 18 18 18
18 18 18 18 18 18 18 21 21 21 21 21 21 21 21 21 21 21 18 18 18 18 18 18 18
18 18 18 18 18 18 18 21 21 21 21 21 21 21 21 21 21 21 18 18 18 18 18 18 18
18 18 18 18 18 18 18 21 21 21 21 21 21 21 21 21 21 21 18 18 18 18 18 18 18
18 18 18 18 18 18 18 18 18 18 18 13 14 18 18 18 18 18 18 18 18 18 18 18 18