100 75
16 16 16 16 16 16 16 16 16 16 16 16 16 16 16 16 16 16 16 16 16 16 16 16 16 16 16 16 16 16 16 16 16 16 16 16 16 16 16 16 16 16 16 16 16 16 16 16 16 16 16 16 16 16 16 16 16 16 16 16 16 16 16 16 16 16 16 16 16 16 16 16 16 16 16 16 16 16 16 16 16 16 16 16 16 16 16 16 16 16 16 16 16 16 16 16 16 16 16 16
16 16 16 16 16 16 16 16 16 16 16 16 16 16 16 16 16 16 16 16 16 16 16 16 16 16 16 16 16 16 16 16 16 16 16 16 16 16 16 16 16 16 16 16 16 16 16 16 16 16 16 16 16 16 16 16 16 16 16 16 16 16 16 16 16 16 16 16 16 16 16 16 16 16 16 16 16 16 16 16 16 16 16 16 16 16 16 16 16 16 16 16 16 16 16 16 16 16 16 16
16 16 49 49 49 49 49 49 49 49 49 49 49 49 49 49 49 49 49 49 49 49 49 49 49 49 49 49 49 49 49 49 49 49 49 49 49 49 49 49 49 49 49 49 49 49 49 49 49 49 49 49 49 49 49 49 49 49 49 49 49 49 49 49 49 49 49 49 49 49 49 49 49 49 49 49 49 49 49 49 49 49 49 49 49 49 49 49 49 49 49 49 49 49 49 49 49 49 16 16
16 16 49 28 28 28 28 28 28 28 28 28 28 28 28 28 28 28 1 1 2 2 3 3 28 28 28 28 28 28 28 28 28 28 28 28 28 28 28 28 28 28 1 2 2 3 3 21 28 28 28 28 28 28 28 28 28 28 28 28 28 28 28 28 28 28 1 1 2 3 3 3 28 28 28 28 28 28 28 28 28 28 28 28 28 28 28 28 28 28 28 28 28 28 28 28 28 49 16 16
16 16 49 28 28 28 28 28 28 28 28 28 28 28 28 28 1 1 1 2 2 3 3 21 21 3 28 28 28 28 28 28 28 28 28 28 28 28 28 28 1 1 2 2 3 3 21 21 3 3 28 28 28 28 28 28 28 28 28 28 28 28 28 28 1 1 2 2 3 3 21 21 3 3 28 28 28 28 28 28 28 28 28 28 28 28 28 28 110 110 110 110 110 110 110 28 28 49 16 16
16 16 49 28 28 1 1 2 2 3 3 21 28 28 28 28 1 2 2 3 3 21 21 1 1 3 28 28 28 28 1 1 2 3 3 21 28 28 28 28 1 2 2 3 3 21 21 1 1 3 28 28 28 28 1 2 2 3 3 21 28 28 28 28 1 2 2 3 3 21 21 1 1 3 28 28 28 28 1 1 2 3 3 21 28 28 28 28 28 28 28 28 28 28 28 28 28 49 16 16
16 16 49 28 28 1 2 2 3 3 21 21 28 28 28 28 2 3 3 21 21 1 1 2 2 3 28 28 28 28 1 2 3 3 21 21 28 28 28 28 2 3 3 21 21 1 1 2 2 3 28 28 28 28 2 3 3 21 21 1 28 28 28 28 2 3 3 21 21 1 1 2 2 3 28 28 28 28 1 2 3 3 21 21 28 28 28 1 1 1 2 2 2 3 3 3 21 49 16 16
16 16 49 28 28 2 3 3 21 21 1 1 28 28 28 28 3 21 21 1 1 2 2 3 3 21 28 28 28 28 2 3 21 21 1 1 28 28 28 28 3 21 21 1 1 2 2 3 3 21 28 28 28 28 3 21 21 1 1 2 28 28 28 28 3 21 21 1 1 2 2 3 3 21 28 28 28 28 2 3 21 21 1 1 28 28 28 1 2 2 3 3 21 21 1 1 21 49 16 16
16 16 49 28 28 3 21 21 1 1 2 2 28 28 28 28 21 1 1 2 2 3 3 21 21 1 28 28 28 28 3 21 1 1 2 2 28 28 28 28 21 1 1 2 2 3 3 21 21 1 28 28 28 28 21 1 1 2 2 3 28 28 28 28 21 1 1 2 2 3 3 21 21 1 28 28 28 28 3 21 1 1 2 2 28 28 28 2 3 3 21 21 1 1 2 2 21 49 16 16
16 16 49 28 28 21 1 1 2 2 3 3 28 28 28 28 1 2 2 3 3 21 21 1 1 2 28 28 28 28 21 1 2 2 3 3 28 28 28 28 1 2 2 3 3 21 21 1 1 2 28 28 28 28 1 2 2 3 3 21 28 28 28 28 1 2 2 3 3 21 21 1 1 2 28 28 28 28 21 1 2 2 3 3 28 28 28 3 21 21 1 1 2 2 3 3 21 49 16 16
16 16 49 28 28 1 2 2 3 3 21 21 28 28 28 28 2 3 3 21 21 1 1 2 2 3 28 28 28 28 1 2 3 3 21 21 28 28 28 28 2 3 3 21 21 1 1 2 2 3 28 28 28 28 2 3 3 21 21 1 28 28 28 28 2 3 3 21 21 1 1 2 2 3 28 28 28 28 1 2 3 3 21 21 28 28 28 21 1 1 2 2 3 3 21 21 21 49 16 16
16 16 49 28 28 2 3 3 21 21 1 1 28 28 28 28 3 21 21 1 1 2 2 3 3 54 28 28 28 28 2 3 21 21 1 1 28 28 28 28 3 21 21 1 1 2 2 3 3 54 28 28 28 28 3 21 21 1 1 2 28 28 28 28 3 21 21 1 1 2 2 3 3 54 28 28 28 28 2 3 21 21 1 1 28 28 28 1 2 2 3 3 21 21 1 1 21 49 16 16
16 16 49 28 28 3 54 54 1 1 2 2 28 28 28 28 54 54 1 2 2 3 3 54 54 1 28 28 28 28 3 54 54 1 2 2 28 28 28 28 54 54 1 2 2 3 3 54 54 1 28 28 28 28 54 54 1 2 2 3 28 28 28 28 54 54 1 2 2 3 3 54 54 1 28 28 28 28 3 54 54 1 2 2 28 28 28 2 3 3 54 54 1 1 2 2 21 49 16 16
16 16 49 28 28 28 28 28 28 28 28 28 28 28 28 28 28 28 28 28 28 28 28 28 28 28 28 28 28 28 28 28 28 28 28 28 28 28 28 28 28 28 28 28 28 28 28 28 28 28 28 28 28 28 28 28 28 28 28 28 28 28 28 28 28 28 28 28 28 28 28 28 28 28 28 28 28 28 28 28 28 28 28 28 28 28 28 28 28 28 28 28 28 28 28 28 28 49 16 16
16 16 49 28 28 28 28 28 28 28 28 28 28 28 28 28 28 1 1 2 2 3 3 21 28 28 28 28 28 28 28 28 28 28 28 28 28 28 28 28 28 1 2 2 3 3 21 21 28 28 28 28 28 28 28 28 28 28 28 28 28 28 28 28 28 1 1 2 3 3 21 21 28 28 28 28 28 28 28 28 28 28 28 28 28 28 28 28 110 110 110 110 110 110 28 28 28 49 16 16
16 16 49 28 28 28 28 28 28 28 28 28 28 28 28 28 1 1 2 2 3 3 21 21 3 3 28 28 28 28 28 28 28 28 28 28 28 28 28 28 1 1 2 3 3 21 21 1 1 3 28 28 28 28 28 28 28 28 28 28 28 28 28 28 1 1 2 3 3 21 21 1 1 3 28 28 28 28 28 28 28 28 28 28 28 28 28 28 28 28 28 28 28 28 28 28 28 49 16 16
16 16 49 28 28 1 2 2 3 3 21 21 28 28 28 28 1 2 3 3 21 21 1 1 1 3 28 28 28 28 1 1 2 3 3 21 28 28 28 28 2 2 3 21 21 1 1 2 2 3 28 28 28 28 1 2 2 3 3 21 28 28 28 28 1 2 3 21 21 1 1 2 2 3 28 28 28 28 1 1 2 3 3 21 28 28 28 1 1 2 2 3 3 21 21 3 21 49 16 16
16 16 49 28 28 2 3 3 21 21 1 1 28 28 28 28 2 3 21 21 1 1 2 2 2 3 28 28 28 28 1 2 3 21 21 1 28 28 28 28 3 3 21 1 1 2 2 3 3 21 28 28 28 28 2 3 21 21 1 1 28 28 28 28 2 3 21 1 1 2 2 3 3 21 28 28 28 28 1 2 3 21 21 1 28 28 28 2 2 3 3 21 21 1 1 3 3 49 16 16
16 16 49 28 28 3 21 21 1 1 2 2 28 28 28 28 3 21 1 1 2 2 3 3 3 21 28 28 28 28 2 3 21 1 1 2 28 28 28 28 21 21 1 2 2 3 3 21 21 1 28 28 28 28 3 21 1 1 2 2 28 28 28 28 3 21 1 1 2 3 3 21 21 1 28 28 28 28 2 3 21 1 1 2 28 28 28 3 3 21 21 1 1 2 2 3 21 49 16 16
16 16 49 28 28 21 1 1 2 2 3 3 28 28 28 28 21 1 2 2 3 3 21 21 21 1 28 28 28 28 3 21 1 2 2 3 28 28 28 28 1 1 2 3 3 21 21 1 1 2 28 28 28 28 21 1 2 2 3 3 28 28 28 28 21 1 2 2 3 21 21 1 1 2 28 28 28 28 3 21 1 2 2 3 28 28 28 21 21 1 1 2 2 3 3 21 21 49 16 16
16 16 49 28 28 1 2 2 3 3 21 21 28 28 28 28 1 2 3 3 21 21 1 1 1 2 28 28 28 28 21 1 2 3 3 21 28 28 28 28 2 2 3 21 21 1 1 2 2 3 28 28 28 28 1 2 3 21 21 1 28 28 28 28 1 2 3 21 21 1 1 2 2 3 28 28 28 28 21 1 2 3 3 21 28 28 28 1 1 2 2 3 3 21 21 1 21 49 16 16
16 16 49 28 28 2 3 3 21 21 1 1 28 28 28 28 2 3 21 21 1 1 2 2 2 3 28 28 28 28 1 2 3 21 21 1 28 28 28 28 3 3 21 1 1 2 2 3 3 54 28 28 28 28 2 3 21 1 1 2 28 28 28 28 2 3 21 1 1 2 2 3 3 54 28 28 28 28 1 2 3 21 21 1 28 28 28 2 2 3 3 21 21 1 1 2 21 49 16 16
16 16 49 28 28 3 54 54 1 1 2 2 28 28 28 28 3 54 54 1 2 2 3 3 3 54 28 28 28 28 2 3 54 54 1 2 28 28 28 28 54 54 1 2 3 3 54 54 1 2 28 28 28 28 3 54 54 1 2 3 28 28 28 28 3 54 54 1 2 3 54 54 1 2 28 28 28 28 2 3 54 54 1 2 28 28 28 3 3 54 54 1 1 2 2 3 21 49 16 16
16 16 49 28 28 28 28 28 28 28 28 28 28 28 28 28 28 28 28 28 28 28 28 28 28 28 28 28 28 28 28 28 28 28 28 28 28 28 28 28 28 28 28 28 28 28 28 28 28 28 28 28 28 28 28 28 28 28 28 28 28 28 28 28 28 28 28 28 28 28 28 28 28 28 28 28 28 28 28 28 28 28 28 28 28 28 28 28 28 28 28 28 28 28 28 28 28 49 16 16
16 16 49 28 28 28 28 28 28 28 28 28 28 28 28 28 28 1 1 2 2 3 3 21 28 28 28 28 28 28 28 28 28 28 28 28 28 28 28 28 28 1 2 2 3 3 21 21 28 28 28 28 28 28 28 28 28 28 28 28 28 28 28 28 28 1 1 2 3 3 21 21 28 28 28 28 28 28 28 28 28 28 28 28 28 28 28 28 110 110 110 110 110 110 28 28 28 49 16 16
16 16 49 28 28 28 28 28 28 28 28 28 28 28 28 28 1 1 2 3 3 21 21 1 1 3 28 28 28 28 28 28 28 28 28 28 28 28 28 28 1 2 2 3 21 21 1 1 2 3 28 28 28 28 28 28 28 28 28 28 28 28 28 28 1 2 2 3 21 21 1 1 2 3 28 28 28 28 28 28 28 28 28 28 28 28 28 28 28 28 28 28 28 28 28 28 28 49 16 16
16 16 49 28 28 1 1 2 3 3 21 21 28 28 28 28 1 2 3 21 21 1 1 2 2 3 28 28 28 28 1 2 2 3 3 21 28 28 28 28 2 3 3 21 1 1 2 2 3 21 28 28 28 28 1 2 3 3 21 21 28 28 28 28 1 2 3 21 1 1 2 2 3 21 28 28 28 28 1 2 2 3 3 21 28 28 28 1 1 2 2 3 3 21 21 3 21 49 16 16
16 16 49 28 28 1 2 3 21 21 1 1 28 28 28 28 2 3 21 1 1 2 2 3 3 21 28 28 28 28 2 3 3 21 21 1 28 28 28 28 3 21 21 1 2 2 3 3 21 1 28 28 28 28 2 3 21 21 1 1 28 28 28 28 2 3 21 1 1 2 3 3 21 1 28 28 28 28 2 3 3 21 21 1 28 28 28 2 2 3 3 21 21 1 1 3 3 49 16 16
16 16 49 28 28 2 3 21 1 1 2 2 2 28 28 28 3 21 1 2 2 3 3 21 21 1 28 28 28 28 3 21 21 1 1 2 28 28 28 28 21 1 1 2 3 3 21 21 1 2 28 28 28 28 3 21 1 1 2 2 28 28 28 28 3 21 1 1 2 3 21 21 1 2 28 28 28 28 3 21 21 1 1 2 28 28 28 3 3 21 21 1 1 2 2 3 21 49 16 16
16 16 49 28 28 3 21 1 2 2 3 3 28 28 28 28 21 1 2 3 3 21 21 1 1 2 28 28 28 28 21 1 1 2 2 3 28 28 28 28 1 2 2 3 21 21 1 1 2 3 28 28 28 28 21 1 2 2 3 3 28 28 28 28 21 1 2 2 3 21 1 1 2 3 28 28 28 28 21 1 1 2 2 3 28 28 28 21 21 1 1 2 2 3 3 21 21 49 16 16
16 16 49 28 28 21 1 2 3 3 21 21 28 28 28 28 1 2 3 21 21 1 1 2 2 3 28 28 28 28 1 2 2 3 3 21 28 28 28 28 2 3 3 21 1 1 2 2 3 21 28 28 28 28 1 2 3 21 21 1 28 28 28 28 1 2 3 21 21 1 2 2 3 21 28 28 28 28 1 2 2 3 3 21 28 28 28 1 1 2 2 3 3 21 21 1 21 49 16 16
16 16 49 28 28 1 2 3 21 21 1 1 28 28 28 28 2 3 21 1 1 2 2 3 3 54 28 28 28 28 2 3 3 21 21 1 28 28 28 28 3 21 21 1 2 2 3 3 54 1 28 28 28 28 2 3 21 1 1 2 28 28 28 28 2 3 21 1 1 2 3 3 54 1 28 28 28 28 2 3 3 21 21 1 28 28 28 2 2 3 3 21 21 1 1 2 21 49 16 16
16 16 49 28 28 2 3 54 54 1 2 2 28 28 28 28 3 54 54 1 2 3 3 54 54 1 28 28 28 28 3 54 54 1 1 2 28 28 28 28 54 54 1 2 3 3 54 54 1 2 28 28 28 28 3 54 54 1 2 3 28 28 28 28 3 54 54 1 2 3 54 54 1 2 28 28 28 28 3 54 54 1 1 2 28 28 28 3 3 54 54 1 1 2 2 3 21 49 16 16
16 16 49 28 28 28 28 28 28 28 28 28 28 28 28 28 28 28 28 28 28 28 28 28 28 28 28 28 28 28 28 28 28 28 28 28 28 28 28 28 28 28 28 28 28 28 28 28 28 28 28 28 28 28 28 28 28 28 28 28 28 28 28 28 28 28 28 28 28 28 28 28 28 28 28 28 28 28 28 28 28 28 28 28 28 28 28 28 28 28 28 28 28 28 28 28 28 49 16 16
16 16 49 28 28 28 28 28 28 28 28 28 28 28 28 28 28 1 1 2 2 3 3 21 28 28 28 28 28 28 28 28 28 28 28 28 28 28 28 28 28 1 2 2 3 3 21 21 28 28 28 28 28 28 28 28 28 28 28 28 28 28 28 28 28 1 1 2 3 3 21 21 28 28 28 28 28 28 28 28 28 28 28 28 28 28 28 28 110 110 110 110 110 110 28 28 28 49 16 16
16 16 49 28 28 28 28 28 28 28 28 28 28 28 28 28 1 1 2 3 3 21 21 1 1 3 28 28 28 28 28 28 28 28 28 28 28 28 28 28 1 2 2 3 21 21 1 1 2 3 28 28 28 28 28 28 28 28 28 28 28 28 28 28 1 2 2 3 21 21 1 1 2 3 28 28 28 28 28 28 28 28 28 28 28 28 28 28 28 28 28 28 28 28 28 28 28 49 16 16
16 16 49 28 28 1 1 2 3 3 21 21 28 28 28 28 1 2 3 21 21 1 1 2 2 3 28 28 28 28 1 2 2 3 3 21 28 28 28 28 2 3 3 21 1 1 2 2 3 21 28 28 28 28 1 2 3 3 21 21 28 28 28 28 1 2 3 21 1 1 2 2 3 21 28 28 28 28 1 2 2 3 3 21 28 28 28 1 1 2 2 3 3 21 21 3 21 49 16 16
16 16 49 28 28 1 2 3 21 21 1 1 28 28 28 28 2 3 21 1 1 2 2 3 3 21 28 28 28 28 2 3 3 21 21 1 28 28 28 28 3 21 21 1 2 2 3 3 21 1 28 28 28 28 2 3 21 21 1 1 28 28 28 28 2 3 21 1 1 2 3 3 21 1 28 28 28 28 2 3 3 21 21 1 28 28 28 2 2 3 3 21 21 1 1 3 3 49 16 16
16 16 49 28 28 2 3 21 1 1 2 2 2 28 28 28 3 21 1 2 2 3 3 21 21 1 28 28 28 28 3 21 21 1 1 2 28 28 28 28 21 1 1 2 3 3 21 21 1 2 28 28 28 28 3 21 1 1 2 2 28 28 28 28 3 21 1 1 2 3 21 21 1 2 28 28 28 28 3 21 21 1 1 2 28 28 28 3 3 21 21 1 1 2 2 3 21 49 16 16
16 16 49 28 28 3 21 1 2 2 3 3 28 28 28 28 21 1 2 3 3 21 21 1 1 2 28 28 28 28 21 1 1 2 2 3 28 28 28 28 1 2 2 3 21 21 1 1 2 3 28 28 28 28 21 1 2 2 3 3 28 28 28 28 21 1 2 2 3 21 1 1 2 3 28 28 28 28 21 1 1 2 2 3 28 28 28 21 21 1 1 2 2 3 3 21 21 49 16 16
16 16 49 28 28 21 1 2 3 3 21 21 28 28 28 28 1 2 3 21 21 1 1 2 2 3 28 28 28 28 1 2 2 3 3 21 28 28 28 28 2 3 3 21 1 1 2 2 3 21 28 28 28 28 1 2 3 21 21 1 28 28 28 28 1 2 3 21 21 1 2 2 3 21 28 28 28 28 1 2 2 3 3 21 28 28 28 1 1 2 2 3 3 21 21 1 28 49 16 16
16 16 49 28 28 28 28 28 28 28 28 28 28 28 28 28 28 28 28 28 28 28 28 28 28 28 28 28 28 28 28 28 28 28 28 28 28 28 28 28 28 28 28 28 28 28 28 28 28 28 28 28 28 28 28 28 28 28 28 28 28 28 28 28 28 28 28 28 28 28 28 28 28 28 28 28 28 28 28 28 28 28 28 28 28 28 28 28 54 54 54 54 54 54 54 54 28 49 16 16
16 16 49 28 28 28 28 28 28 28 28 28 28 28 28 28 28 1 1 2 3 3 21 21 28 28 28 28 28 28 28 28 28 28 28 28 28 28 28 28 28 1 1 2 3 3 21 21 28 28 28 28 28 28 28 28 28 28 28 28 28 28 28 28 28 1 1 2 3 3 21 21 28 28 28 28 28 28 28 28 28 28 28 28 28 28 28 28 110 110 110 110 110 110 28 28 28 49 16 16
16 16 49 28 28 28 28 28 28 28 28 28 28 28 28 28 1 1 2 3 3 21 21 1 1 3 28 28 28 28 28 28 28 28 28 28 28 28 28 28 1 2 2 3 21 21 1 1 2 3 28 28 28 28 28 28 28 28 28 28 28 28 28 28 1 2 2 3 21 21 1 1 2 3 28 28 28 28 28 28 28 28 28 28 28 28 28 28 28 28 28 28 28 28 28 28 28 49 16 16
16 16 49 28 28 1 1 2 3 3 21 21 28 28 28 28 1 2 3 21 21 1 1 2 2 3 28 28 28 28 1 2 2 3 3 21 28 28 28 28 2 3 3 21 1 1 2 2 3 21 28 28 28 28 1 2 3 3 21 21 28 28 28 28 1 2 3 21 1 1 2 2 3 21 28 28 28 28 1 2 2 3 3 21 28 28 28 1 1 2 2 3 3 21 21 3 21 49 16 16
16 16 49 28 28 1 2 3 21 21 1 1 28 28 28 28 2 3 21 1 1 2 2 3 3 21 28 28 28 28 2 3 3 21 21 1 28 28 28 28 3 21 21 1 2 2 3 3 21 1 28 28 28 28 2 3 21 21 1 1 28 28 28 28 2 3 21 1 1 2 3 3 21 1 28 28 28 28 2 3 3 21 21 1 28 28 28 2 2 3 3 21 21 1 1 3 3 49 16 16
16 16 49 28 28 2 3 21 1 1 2 2 28 28 28 28 3 21 1 2 2 3 3 21 21 1 28 28 28 28 3 21 21 1 1 2 28 28 28 28 21 1 1 2 3 3 21 21 1 2 28 28 28 28 3 21 1 1 2 2 28 28 28 28 3 21 1 1 2 3 21 21 1 2 28 28 28 28 3 21 21 1 1 2 28 28 28 3 3 21 21 1 1 2 2 3 21 49 16 16
16 16 49 28 28 3 21 1 2 2 3 3 28 28 28 28 21 1 2 3 3 21 21 1 1 2 28 28 28 28 21 1 1 2 2 3 28 28 28 28 1 2 2 3 21 21 1 1 2 3 28 28 28 28 21 1 2 2 3 3 28 28 28 28 21 1 2 2 3 21 1 1 2 3 28 28 28 28 21 1 1 2 2 3 28 28 28 21 21 1 1 2 2 3 3 21 21 49 16 16
16 16 49 28 28 21 1 2 3 3 21 21 28 28 28 28 1 2 3 21 21 1 1 2 2 3 28 28 28 28 1 2 2 3 3 21 28 28 28 28 2 3 3 21 1 1 2 2 3 21 28 28 28 28 1 2 3 21 21 1 28 28 28 28 1 2 3 21 21 1 2 2 3 21 28 28 28 28 1 2 2 3 3 21 28 28 28 1 1 2 2 3 3 21 21 1 28 49 16 16
16 16 49 28 28 28 28 28 28 28 28 28 28 28 28 28 28 28 28 28 28 28 28 28 28 28 28 28 28 28 28 28 28 28 28 28 28 28 28 28 28 28 28 28 28 28 28 28 28 28 28 28 28 28 28 28 28 28 28 28 28 28 28 28 28 28 28 28 28 28 28 28 28 28 28 28 28 28 28 28 28 28 28 28 28 28 28 28 54 54 54 54 54 54 54 54 28 49 16 16
16 16 49 28 28 28 28 28 28 28 28 28 28 28 28 28 28 28 28 28 28 28 28 28 28 28 28 28 28 28 28 28 28 28 28 28 28 28 28 28 28 28 28 28 28 28 28 28 28 28 28 28 28 28 28 28 28 28 28 28 28 28 28 28 28 28 28 28 28 28 28 28 28 28 28 28 28 28 28 28 28 28 28 28 28 28 28 28 2 54 54 54 54 54 54 54 28 49 16 16
16 16 49 28 28 2 3 3 21 21 1 1 28 28 28 28 2 3 21 1 1 2 2 3 3 54 28 28 28 28 1 2 3 21 21 1 28 28 28 28 3 21 21 1 2 2 3 3 54 1 28 28 28 28 2 3 21 1 1 2 28 28 28 28 2 3 21 1 1 2 3 3 54 1 28 28 28 28 1 2 3 21 21 1 28 28 28 2 2 3 3 21 21 1 1 2 21 49 16 16
16 16 49 28 28 3 54 54 1 1 2 2 28 28 28 28 3 54 54 1 2 3 3 54 54 1 28 28 28 28 2 3 54 54 1 2 28 28 28 28 54 54 1 2 3 3 54 54 1 2 28 28 28 28 3 54 54 1 2 3 28 28 28 28 3 54 54 1 2 3 54 54 1 2 28 28 28 28 2 3 54 54 1 2 28 28 28 3 3 54 54 1 1 2 2 3 21 49 16 16
16 16 49 28 28 2 3 3 21 21 1 1 28 28 28 28 2 3 21 1 1 2 2 3 3 54 28 28 28 28 1 2 3 21 21 1 28 28 28 28 3 21 21 1 2 2 3 3 54 1 28 28 28 28 2 3 21 1 1 2 28 28 28 28 2 3 21 1 1 2 3 3 54 1 28 28 28 28 1 2 3 21 21 1 28 28 28 2 2 3 3 21 21 1 1 2 21 49 16 16
16 16 49 28 28 3 54 54 1 1 2 2 28 28 28 28 3 54 54 1 2 3 3 54 54 1 28 28 28 28 2 3 54 54 1 2 28 28 28 28 54 54 1 2 3 3 54 54 1 2 28 28 28 28 3 54 54 1 2 3 28 28 28 28 3 54 54 1 2 3 54 54 1 2 28 28 28 28 2 3 54 54 1 2 28 28 28 3 3 54 54 1 1 2 2 3 21 49 16 16
16 16 49 28 28 28 28 28 28 28 28 28 28 28 28 28 28 28 28 28 28 28 28 28 28 28 28 28 28 28 28 28 28 28 28 28 28 28 28 28 28 28 28 28 28 28 28 28 28 28 28 28 28 28 28 28 28 28 28 28 28 28 28 28 28 28 28 28 28 28 28 28 28 28 28 28 28 28 28 28 28 28 28 28 28 28 28 28 28 28 28 28 28 28 28 28 28 49 16 16
16 16 49 28 28 28 28 28 28 28 28 28 28 28 28 28 28 1 1 2 3 3 21 21 28 28 28 28 28 28 28 28 28 28 28 28 28 28 28 28 28 1 1 2 3 3 21 21 28 28 28 28 28 28 28 28 28 28 28 28 28 28 28 28 28 1 1 2 3 3 21 21 28 28 28 28 28 28 28 28 28 28 28 28 28 28 28 28 110 110 110 110 110 110 28 28 28 49 16 16
16 16 49 28 28 28 28 28 28 28 28 28 28 28 28 28 1 1 2 3 3 21 21 1 1 3 28 28 28 28 28 28 28 28 28 28 28 28 28 28 1 2 2 3 21 21 1 1 2 3 28 28 28 28 28 28 28 28 28 28 28 28 28 28 1 2 2 3 21 21 1 1 2 3 28 28 28 28 28 28 28 28 28 28 28 28 28 28 28 28 28 28 28 28 28 28 28 49 16 16
16 16 49 28 28 1 1 2 3 3 21 21 28 28 28 28 1 2 3 21 21 1 1 2 2 3 28 28 28 28 1 2 2 3 3 21 28 28 28 28 2 3 3 21 1 1 2 2 3 21 28 28 28 28 1 2 3 3 21 21 28 28 28 28 1 2 3 21 1 1 2 2 3 21 28 28 28 28 1 2 2 3 3 21 28 28 28 1 1 2 2 3 3 21 21 3 21 49 16 16
16 16 49 28 28 1 2 3 21 21 1 1 28 28 28 28 2 3 21 1 1 2 2 3 3 21 28 28 28 28 2 3 3 21 21 1 28 28 28 28 3 21 21 1 2 2 3 3 21 1 28 28 28 28 2 3 21 21 1 1 28 28 28 28 2 3 21 1 1 2 3 3 21 1 28 28 28 28 2 3 3 21 21 1 28 28 28 2 2 3 3 21 21 1 1 3 3 49 16 16
16 16 49 28 28 2 3 21 1 1 2 2 2 28 28 28 3 21 1 2 2 3 3 21 21 1 28 28 28 28 3 21 21 1 1 2 28 28 28 28 21 1 1 2 3 3 21 21 1 2 28 28 28 28 3 21 1 1 2 2 28 28 28 28 3 21 1 1 2 3 21 21 1 2 28 28 28 28 3 21 21 1 1 2 28 28 28 3 3 21 21 1 1 2 2 3 21 49 16 16
16 16 49 28 28 3 21 1 2 2 3 3 28 28 28 28 21 1 2 3 3 21 21 1 1 2 28 28 28 28 21 1 1 2 2 3 28 28 28 28 1 2 2 3 21 21 1 1 2 3 28 28 28 28 21 1 2 2 3 3 28 28 28 28 21 1 2 2 3 21 1 1 2 3 28 28 28 28 21 1 1 2 2 3 28 28 28 21 21 1 1 2 2 3 3 21 21 49 16 16
16 16 49 28 28 21 1 2 3 3 21 21 28 28 28 28 1 2 3 21 21 1 1 2 2 3 28 28 28 28 1 2 2 3 3 21 28 28 28 28 2 3 3 21 1 1 2 2 3 21 28 28 28 28 1 2 3 21 21 1 28 28 28 28 1 2 3 21 21 1 2 2 3 21 28 28 28 28 1 2 2 3 3 21 28 28 28 1 1 2 2 3 3 21 21 1 28 49 16 16
16 16 49 28 28 28 28 28 28 28 28 28 28 28 28 28 28 28 28 28 28 28 28 28 28 28 28 28 28 28 28 28 28 28 28 28 28 28 28 28 28 28 28 28 28 28 28 28 28 28 28 28 28 28 28 28 28 28 28 28 28 28 28 28 28 28 28 28 28 28 28 28 28 28 28 28 28 28 28 28 28 28 28 28 28 28 28 28 54 54 54 54 54 54 54 54 28 49 16 16
16 16 49 28 28 28 28 28 28 28 28 28 28 28 28 28 28 1 1 2 3 3 21 21 28 28 28 28 28 28 28 28 28 28 28 28 28 28 28 28 28 1 1 2 3 3 21 21 28 28 28 28 28 28 28 28 28 28 28 28 28 28 28 28 28 1 1 2 3 3 21 21 28 28 28 28 28 28 28 28 28 28 28 28 28 28 28 28 110 110 110 110 110 110 28 28 28 49 16 16
16 16 49 28 28 28 28 28 28 28 28 28 28 28 28 28 1 1 2 3 3 21 21 1 1 3 28 28 28 28 28 28 28 28 28 28 28 28 28 28 1 2 2 3 21 21 1 1 2 3 28 28 28 28 28 28 28 28 28 28 28 28 28 28 1 2 2 3 21 21 1 1 2 3 28 28 28 28 28 28 28 28 28 28 28 28 28 28 28 28 28 28 28 28 28 28 28 49 16 16
16 16 49 28 28 1 1 2 3 3 21 21 28 28 28 28 1 2 3 21 21 1 1 2 2 3 28 28 28 28 1 2 2 3 3 21 28 28 28 28 2 3 3 21 1 1 2 2 3 21 28 28 28 28 1 2 3 3 21 21 28 28 28 28 1 2 3 21 1 1 2 2 3 21 28 28 28 28 1 2 2 3 3 21 28 28 28 1 1 2 2 3 3 21 21 3 21 49 16 16
16 16 49 28 28 1 2 3 21 21 1 1 28 28 28 28 2 3 21 1 1 2 2 3 3 21 28 28 28 28 2 3 3 21 21 1 28 28 28 28 3 21 21 1 2 2 3 3 21 1 28 28 28 28 2 3 21 21 1 1 28 28 28 28 2 3 21 1 1 2 3 3 21 1 28 28 28 28 2 3 3 21 21 1 28 28 28 2 2 3 3 21 21 1 1 3 3 49 16 16
16 16 49 28 28 2 3 21 1 1 2 2 2 28 28 28 3 21 1 2 2 3 3 21 21 1 28 28 28 28 3 21 21 1 1 2 28 28 28 28 21 1 1 2 3 3 21 21 1 2 28 28 28 28 3 21 1 1 2 2 28 28 28 28 3 21 1 1 2 3 21 21 1 2 28 28 28 28 3 21 21 1 1 2 28 28 28 3 3 21 21 1 1 2 2 3 21 49 16 16
16 16 49 28 28 3 21 1 2 2 3 3 28 28 28 28 21 1 2 3 3 21 21 1 1 2 28 28 28 28 21 1 1 2 2 3 28 28 28 28 1 2 2 3 21 21 1 1 2 3 28 28 28 28 21 1 2 2 3 3 28 28 28 28 21 1 2 2 3 21 1 1 2 3 28 28 28 28 21 1 1 2 2 3 28 28 28 21 21 1 1 2 2 3 3 21 21 49 16 16
16 16 49 28 28 21 1 2 3 3 21 21 28 28 28 28 1 2 3 21 21 1 1 2 2 3 28 28 28 28 1 2 2 3 3 21 28 28 28 28 2 3 3 21 1 1 2 2 3 21 28 28 28 28 1 2 3 21 21 1 28 28 28 28 1 2 3 21 21 1 2 2 3 21 28 28 28 28 1 2 2 3 3 21 28 28 28 1 1 2 2 3 3 21 21 1 28 49 16 16
16 16 49 28 28 28 28 28 28 28 28 28 28 28 28 28 28 28 28 28 28 28 28 28 28 28 28 28 28 28 28 28 28 28 28 28 28 28 28 28 28 28 28 28 28 28 28 28 28 28 28 28 28 28 28 28 28 28 28 28 28 28 28 28 28 28 28 28 28 28 28 28 28 28 28 28 28 28 28 28 28 28 28 28 28 28 28 28 54 54 54 54 54 54 54 54 28 49 16 16
16 16 49 49 49 49 49 49 49 49 49 49 49 49 49 49 49 49 49 49 49 49 49 49 49 49 49 49 49 49 49 49 49 49 49 49 49 49 49 49 49 49 49 49 49 49 49 49 49 49 49 49 49 49 49 49 49 49 49 49 49 49 49 49 49 49 49 49 49 49 49 49 49 49 49 49 49 49 49 49 49 49 49 49 49 49 49 49 49 49 49 49 49 49 49 49 49 49 16 16
16 16 16 16 16 16 16 16 16 16 16 16 16 16 16 16 16 16 16 16 16 16 16 16 16 16 16 16 16 16 16 16 16 16 16 16 16 16 16 16 16 16 16 16 16 16 16 16 16 16 16 16 16 16 16 16 16 16 16 16 16 16 16 16 16 16 16 16 16 16 16 16 16 16 16 16 16 16 16 16 16 16 16 16 16 16 16 16 16 16 16 16 16 16 16 16 16 16 16 16
16 16 16 16 16 16 16 16 16 16 16 16 16 16 16 16 16 16 16 16 16 16 16 16 16 16 16 16 16 16 16 16 16 16 16 16 16 16 16 16 16 16 16 16 16 16 16 16 16 16 16 16 16 16 16 16 16 16 16 16 16 16 16 16 16 16 16 16 16 16 16 16 16 16 16 16 16 16 16 16 16 16 16 16 16 16 16 16 16 16 16 16 16 16 16 16 16 16 16 16
