80 80
34 34 34 34 34 34 34 34 34 34 34 34 34 34 34 34 34 34 34 34 34 34 34 34 34 34 34 34 34 34 34 34 34 34 34 34 34 34 34 34 34 34 34 34 34 34 34 34 34 34 34 34 34 34 34 34 34 34 34 34 34 34 34 34 34 34 34 34 34 34 34 34 34 34 34 34 34 34 34 34
34 34 34 34 34 34 34 34 34 34 34 34 34 34 34 34 34 34 34 34 34 34 34 34 34 34 34 34 34 34 34 34 34 34 34 34 34 34 34 34 34 34 34 34 34 34 34 34 34 34 34 34 34 34 34 34 34 34 34 34 34 34 34 34 34 34 34 34 34 34 34 34 34 34 34 34 34 34 34 34
34 34 49 49 49 49 49 49 49 49 49 49 49 49 49 49 49 49 49 49 49 49 49 49 49 49 49 49 49 49 49 49 49 49 49 49 49 49 49 49 49 49 49 49 49 49 49 49 49 49 49 49 49 49 49 49 49 49 49 49 49 49 49 49 49 49 49 49 49 49 49 49 49 49 49 49 49 49 49 34
34 34 49 61 61 61 61 61 61 61 61 61 61 61 61 61 61 73 73 73 73 73 73 73 28 28 28 28 28 28 28 28 28 28 28 28 28 28 28 49 10 10 10 10 10 10 10 10 10 10 49 28 28 28 28 28 28 28 28 28 28 28 28 28 28 28 28 28 28 28 28 28 28 28 28 28 28 28 49 34
34 34 49 61 61 61 61 61 61 61 61 61 61 61 61 61 61 73 73 73 73 73 73 73 61 61 28 28 28 49 49 49 49 49 49 49 28 28 28 49 0 1 1 1 1 1 1 1 1 2 49 28 28 28 28 28 28 28 28 28 28 28 28 28 28 28 28 28 28 28 28 28 28 28 28 28 28 28 49 34
34 34 49 61 28 49 49 49 49 49 49 49 61 61 61 61 61 73 73 73 73 73 73 73 61 61 28 28 28 49 0 1 1 1 110 49 28 28 28 49 18 19 19 19 19 19 19 19 19 20 49 28 28 28 28 28 28 28 28 28 28 28 28 28 28 28 28 28 28 28 28 28 28 28 28 28 28 28 49 34
34 34 49 61 28 7 73 73 73 73 73 49 61 61 61 61 73 73 73 73 73 73 73 73 73 61 28 28 28 49 18 19 19 19 20 49 28 28 28 49 18 19 19 19 19 19 19 19 19 20 49 28 28 28 28 28 28 28 28 28 28 28 28 28 28 28 28 28 28 28 28 28 28 28 28 28 28 28 49 34
34 34 49 61 28 49 28 28 28 73 73 49 61 61 61 61 61 73 73 73 73 73 73 73 73 61 28 28 28 49 18 19 19 19 128 49 28 28 28 49 18 19 19 19 19 19 19 19 19 20 49 28 28 28 28 28 28 28 28 28 28 28 28 28 28 28 28 28 28 28 28 28 28 28 28 28 28 28 49 34
34 34 49 61 28 49 73 73 73 73 73 49 61 61 61 61 61 73 73 73 73 73 73 73 61 61 28 28 28 49 18 19 19 19 128 49 28 28 28 49 18 19 19 19 19 19 19 19 19 20 49 28 28 28 28 28 28 28 28 28 28 28 28 28 28 28 28 28 28 28 28 28 28 28 28 28 28 28 49 34
34 34 49 61 61 49 73 73 73 73 73 49 61 61 61 61 61 73 73 73 73 73 73 73 61 61 28 28 28 49 18 19 19 19 128 49 28 28 28 49 18 19 19 19 19 19 19 19 19 20 49 73 28 28 28 28 28 28 28 28 28 28 28 28 28 28 28 28 28 28 28 28 28 28 28 28 28 28 49 34
34 34 49 28 61 49 73 73 73 73 73 49 169 61 61 61 61 73 73 73 73 73 73 73 61 61 28 28 28 49 18 19 19 19 128 49 49 49 49 49 18 19 19 19 19 19 19 19 19 20 49 73 28 28 28 49 49 49 49 49 49 49 49 49 49 49 49 49 49 49 49 49 49 49 49 28 28 28 49 34
34 34 49 28 61 49 73 73 73 73 73 8 61 61 61 61 73 73 73 73 73 73 73 73 61 61 28 28 28 49 18 19 19 19 20 28 28 28 28 28 18 19 19 19 19 19 19 19 19 20 49 73 28 28 28 49 34 34 34 34 34 34 34 34 34 34 34 34 34 34 34 34 34 34 49 28 28 28 49 34
34 34 49 28 61 49 49 49 49 49 49 49 61 61 61 61 61 73 73 73 73 73 73 73 73 73 73 73 73 49 36 37 37 37 38 28 28 28 28 28 36 37 37 37 37 37 37 37 37 38 49 73 28 28 28 49 34 49 82 82 82 82 82 82 82 82 82 82 82 82 82 82 49 34 49 28 28 28 49 34
34 34 49 28 61 61 61 61 61 61 61 61 28 61 61 61 61 61 61 61 61 61 61 61 28 28 28 28 28 49 28 28 28 28 28 28 28 28 28 28 28 28 28 28 28 28 28 28 28 28 49 28 28 28 28 49 34 49 34 34 34 34 34 34 34 34 34 34 34 34 34 34 49 34 49 28 28 28 49 34
34 34 49 28 61 61 61 61 61 61 61 61 28 61 28 28 49 49 49 49 49 49 49 49 49 49 28 28 28 49 28 28 28 28 28 28 28 28 28 28 28 28 28 28 28 28 28 28 28 28 49 28 28 28 28 49 34 49 34 49 49 49 49 49 49 49 49 49 49 49 49 34 49 34 49 28 28 28 49 34
34 34 49 28 28 28 28 28 28 28 28 28 28 61 28 28 49 82 49 49 49 49 49 49 49 49 28 28 28 49 28 28 28 28 28 28 49 49 49 49 0 1 1 1 1 1 1 1 1 2 49 28 28 28 28 49 34 49 34 49 34 34 34 34 34 34 34 34 34 34 49 34 49 34 49 28 28 28 49 34
34 34 49 28 28 108 109 109 109 109 109 110 28 28 28 28 49 82 34 34 34 34 34 34 49 49 28 28 28 49 0 1 1 1 1 2 49 28 28 49 18 19 19 19 19 19 19 19 19 20 49 28 28 28 28 49 34 49 34 49 49 49 49 49 49 49 49 49 49 49 49 34 49 34 49 28 28 28 49 34
34 34 49 28 28 126 49 49 49 49 49 128 28 28 28 28 49 82 34 34 34 34 34 34 49 49 28 28 28 49 18 19 19 19 19 20 49 28 28 49 18 19 19 19 19 19 19 19 19 128 49 28 28 28 28 49 34 49 34 34 34 34 34 34 34 34 34 34 34 34 34 34 49 34 49 28 28 28 49 34
34 34 49 28 28 126 49 108 109 110 49 128 28 28 28 28 49 82 34 34 34 34 34 34 49 49 28 28 28 49 18 19 19 19 19 20 49 28 28 49 18 19 19 19 19 19 19 19 19 20 49 28 28 28 28 49 34 49 49 49 49 49 49 49 49 49 49 49 49 49 49 49 49 34 49 28 28 28 49 34
34 34 49 28 28 7 28 126 127 128 28 8 28 28 28 28 49 82 34 34 34 34 34 34 49 49 28 28 28 49 18 19 19 19 19 20 49 28 28 49 18 19 19 19 19 19 19 19 19 20 49 28 28 28 28 49 34 34 34 34 34 34 34 34 34 34 34 34 34 34 34 34 34 34 49 28 28 28 49 34
34 34 49 28 28 126 49 144 145 146 49 128 28 28 28 28 49 82 34 34 34 34 34 34 49 49 28 28 28 49 18 19 19 19 19 20 49 28 28 49 18 19 19 19 19 19 19 19 19 20 49 28 28 28 28 49 49 49 49 49 49 49 49 49 49 49 49 49 49 49 49 49 49 49 49 28 28 28 49 34
34 34 49 28 28 126 49 49 49 49 49 128 28 28 28 97 49 82 34 34 34 34 34 34 49 49 28 28 28 49 18 19 19 19 19 20 49 28 28 49 18 19 19 19 19 19 19 19 19 20 49 28 28 28 28 28 28 28 28 28 28 28 28 28 28 28 28 28 28 28 28 28 28 28 28 28 28 28 49 34
34 34 49 28 28 144 145 145 145 145 145 146 28 28 28 28 49 49 49 49 49 49 49 49 49 49 28 28 28 49 36 37 37 37 37 38 49 28 28 49 36 37 37 37 37 37 37 37 37 38 49 28 28 28 28 28 28 28 28 28 28 28 28 28 28 28 28 28 28 28 28 28 28 28 28 28 28 28 49 34
34 34 49 28 28 28 28 28 28 28 28 28 28 28 28 28 49 49 49 49 49 49 49 49 49 49 28 28 28 49 49 49 49 49 49 49 49 28 28 49 49 49 49 49 49 49 49 49 49 49 49 28 28 28 28 28 28 28 28 28 28 28 28 28 28 28 28 28 28 28 28 28 28 28 28 28 28 28 49 34
34 34 49 28 28 28 28 28 28 28 28 28 28 28 28 28 28 61 61 61 61 61 61 61 28 28 28 28 28 28 28 28 28 28 28 28 28 28 28 28 28 28 28 28 28 28 28 28 28 28 28 28 28 28 28 28 28 28 28 28 28 28 28 28 108 109 109 109 109 109 109 109 109 110 28 28 28 28 49 34
34 34 49 28 28 73 73 73 73 73 28 28 28 28 28 28 73 73 73 73 73 73 73 73 73 73 73 28 28 28 28 28 28 28 28 28 28 28 28 28 28 28 28 28 28 28 28 28 28 28 28 28 28 28 28 28 28 28 28 28 28 28 28 28 126 19 19 19 19 19 19 19 19 128 28 28 28 28 49 34
34 34 49 28 28 73 73 73 73 73 28 28 28 28 28 28 73 73 73 73 73 73 73 73 73 73 28 28 28 108 109 109 109 109 109 110 28 28 28 28 28 28 28 28 28 28 28 28 28 28 28 28 28 28 28 28 28 28 28 28 28 28 28 28 126 19 19 19 19 19 19 19 19 128 28 28 28 28 49 34
34 34 49 28 28 73 73 73 73 28 28 28 28 28 28 28 73 73 73 73 73 73 73 73 73 73 28 28 28 126 49 49 49 49 49 128 28 28 28 28 28 28 28 28 28 28 28 28 28 28 28 28 28 28 28 28 28 28 28 28 28 28 28 28 126 19 19 19 19 19 19 19 19 128 28 28 28 28 49 34
34 34 49 28 28 73 73 73 73 28 28 28 28 28 28 28 73 73 73 73 73 73 73 73 73 73 28 28 28 126 49 54 55 56 49 128 28 28 28 28 49 49 49 49 49 49 49 49 49 49 49 49 49 49 49 28 28 28 28 28 28 28 28 28 126 19 19 19 19 19 19 19 19 128 28 28 28 28 49 34
34 34 49 28 28 73 73 73 73 28 28 28 28 28 28 28 73 73 73 73 73 73 73 73 73 73 28 28 28 126 49 72 127 74 49 128 28 28 28 28 49 0 1 1 1 1 1 1 1 1 1 1 1 2 49 28 28 28 28 28 28 28 28 28 126 19 19 19 19 19 19 19 19 128 28 28 28 28 49 34
34 34 49 28 28 73 73 73 73 28 28 28 28 28 28 28 73 73 73 73 73 73 73 73 73 73 28 28 28 126 49 72 127 74 49 128 79 28 28 28 49 18 19 19 19 19 19 19 19 19 19 19 19 20 49 28 28 28 28 28 28 28 28 28 126 19 19 19 19 19 19 19 19 128 28 28 28 28 49 34
34 34 49 28 28 73 73 73 73 28 28 28 28 28 28 28 73 73 73 73 73 73 73 73 73 73 28 28 28 126 49 72 127 74 49 128 79 28 28 28 7 18 19 19 54 55 55 55 55 55 56 19 19 20 8 28 28 28 28 28 28 28 28 28 126 19 19 19 19 19 19 19 19 128 28 28 28 28 49 34
34 34 49 28 28 73 73 73 73 28 28 28 28 28 28 28 73 73 73 73 73 73 73 73 73 73 28 28 28 126 49 72 127 74 49 128 79 28 28 28 7 18 19 19 72 28 28 28 28 28 74 19 19 20 8 28 28 28 28 28 28 28 28 28 126 19 19 19 19 19 19 19 19 128 28 28 28 28 49 34
34 34 49 28 28 73 73 73 73 28 28 28 28 28 28 28 28 28 28 28 28 28 28 28 28 28 28 28 28 7 18 20 127 74 20 8 79 28 28 28 7 18 19 19 72 28 28 28 28 28 74 19 19 20 8 28 28 28 28 28 28 28 28 28 126 19 19 19 19 19 19 19 19 128 28 28 28 28 49 34
34 34 49 28 28 73 73 73 73 28 28 28 28 28 28 28 49 49 49 49 49 49 49 49 49 49 28 28 28 7 18 72 127 74 20 8 28 28 28 28 7 18 19 19 90 91 91 91 91 91 92 19 19 20 8 28 28 28 28 28 28 28 28 28 126 19 19 19 19 19 19 19 19 128 28 28 28 28 49 34
34 34 49 28 49 49 49 49 49 49 49 49 49 28 28 28 49 0 1 1 1 1 1 1 2 49 28 28 28 7 18 72 127 74 20 8 28 28 28 28 49 18 19 19 19 19 19 19 19 19 19 19 19 20 49 28 28 28 28 28 28 28 28 28 126 19 19 19 19 19 19 19 19 128 28 28 28 28 49 34
34 34 49 28 49 28 28 28 28 28 28 32 49 28 28 28 7 18 19 19 19 19 19 19 20 8 28 28 28 126 49 72 127 74 49 128 28 28 28 28 49 36 37 37 37 37 37 37 37 37 37 37 37 38 49 28 28 28 28 28 28 28 28 28 126 19 19 19 19 19 19 19 19 128 28 28 28 28 49 34
34 34 49 28 49 28 49 49 49 49 49 32 49 28 28 28 7 18 19 19 19 19 19 19 20 8 28 28 28 126 49 72 127 74 49 128 28 28 28 28 49 49 49 49 49 49 49 49 49 49 49 49 49 49 49 28 28 28 28 28 28 28 28 28 126 19 19 19 19 19 19 19 19 128 28 28 28 28 49 34
34 34 49 28 49 28 49 34 34 34 49 32 49 28 28 28 7 18 19 19 19 19 19 19 20 8 28 28 28 126 49 72 127 74 49 128 28 28 28 28 28 28 28 28 28 28 28 28 28 28 28 28 28 28 28 28 28 28 28 28 28 28 28 28 126 19 19 19 19 19 19 19 19 128 28 28 28 28 49 34
34 34 49 28 49 28 49 49 49 49 49 32 49 28 28 28 49 36 37 37 37 37 37 37 38 49 28 28 28 126 49 90 91 92 49 128 28 28 28 28 28 28 28 28 28 28 28 28 28 28 28 28 28 28 28 28 28 28 28 28 28 28 28 28 126 19 19 19 19 19 19 19 19 128 28 28 28 28 49 34
34 34 49 28 49 28 28 28 28 28 28 32 49 28 28 28 49 49 49 49 49 49 49 49 49 49 28 28 28 126 49 49 49 49 49 128 28 28 0 1 1 1 1 1 1 1 1 1 1 1 1 2 28 28 28 28 28 28 28 28 28 28 28 28 126 19 19 19 19 19 19 19 19 128 28 28 28 28 49 34
34 34 49 28 49 49 49 132 132 132 49 49 49 28 28 28 28 28 28 28 28 28 28 28 28 28 28 28 28 144 145 145 145 145 145 146 28 28 18 49 49 49 49 49 49 49 49 49 49 49 49 20 28 28 28 28 28 28 28 28 28 28 28 28 126 19 19 19 19 19 19 19 19 128 28 28 28 28 49 34
34 34 49 28 28 28 28 28 28 28 28 28 28 28 28 28 73 73 73 73 73 28 73 73 73 73 62 28 28 28 28 28 28 28 28 28 28 28 18 49 28 28 28 28 28 28 28 49 34 34 49 20 28 28 28 28 28 28 28 28 28 28 28 28 126 19 19 19 19 19 19 19 19 128 28 28 28 28 49 34
34 34 49 28 28 28 28 28 28 28 28 28 28 49 49 49 49 49 49 49 49 49 73 73 73 73 28 28 28 28 28 28 28 28 28 28 28 28 18 49 28 73 73 73 73 73 28 49 34 34 49 20 28 28 28 28 28 28 28 28 28 28 28 28 126 19 19 19 19 19 19 19 19 128 28 28 28 28 49 34
34 34 49 28 28 73 73 73 73 73 73 73 28 49 73 108 109 109 109 110 73 49 43 43 73 43 43 43 43 28 43 43 43 43 43 43 28 28 18 49 28 28 28 73 73 73 28 49 34 34 49 20 28 28 28 28 28 28 28 28 28 28 28 28 126 19 19 19 19 19 19 19 19 128 28 28 28 28 49 34
34 34 49 28 28 73 73 73 73 73 73 73 28 7 73 126 73 73 73 128 73 49 43 43 43 43 43 43 43 43 43 43 43 43 43 43 43 43 18 49 49 49 28 73 73 73 28 49 34 34 49 20 28 28 28 28 28 28 28 28 28 28 28 28 126 19 19 19 19 19 19 19 19 128 28 28 28 28 49 34
34 34 49 28 28 73 73 73 73 73 73 73 28 7 73 126 73 73 73 128 73 49 49 49 49 49 49 49 49 43 43 43 43 43 43 43 28 28 18 49 34 49 28 73 73 73 28 49 34 34 49 20 28 28 28 28 28 28 28 28 28 28 28 28 126 19 19 19 19 19 19 19 19 128 28 28 28 28 49 34
34 34 49 28 28 73 73 73 73 73 73 73 28 7 73 126 73 73 73 128 73 73 108 109 109 109 109 110 49 43 43 43 43 43 43 43 43 43 18 49 34 49 28 28 28 73 28 49 34 34 49 20 28 28 28 28 28 28 28 28 28 28 28 28 126 19 19 19 19 19 19 19 19 128 28 28 28 28 49 34
34 34 49 28 28 73 73 73 73 73 73 73 28 49 73 126 73 73 73 128 73 73 126 73 73 73 73 128 49 28 43 43 43 43 43 43 43 43 18 49 34 49 49 49 28 28 28 49 34 34 49 20 28 28 28 28 28 28 28 28 28 28 28 28 144 145 145 145 145 145 145 145 145 146 28 28 28 28 49 34
34 34 49 28 28 28 28 28 28 28 28 28 28 49 73 144 145 145 145 146 73 73 126 73 73 73 73 128 49 28 28 28 28 43 43 43 43 43 18 49 34 34 34 49 28 28 28 49 34 34 49 20 28 28 28 28 28 28 28 28 28 28 28 28 28 28 28 28 28 28 28 28 28 28 28 28 28 28 49 34
34 34 49 28 28 28 28 28 28 28 28 28 28 49 49 49 49 49 49 49 49 49 144 145 145 145 145 146 49 28 28 28 43 43 28 43 43 43 18 49 34 34 34 49 28 28 28 49 34 34 49 20 28 28 28 28 28 28 28 28 28 28 28 28 28 28 28 28 28 28 28 28 28 28 28 28 28 28 49 34
34 34 49 28 28 49 49 49 49 49 49 49 28 28 28 28 28 28 28 28 28 49 49 49 49 49 49 49 49 28 43 43 43 43 43 43 43 43 18 49 49 49 49 49 25 25 25 49 49 49 49 20 28 28 61 61 61 61 61 61 61 61 28 61 61 61 61 61 61 61 61 61 61 61 61 61 61 61 49 34
34 34 49 28 28 7 0 1 1 1 2 8 28 28 28 28 28 28 28 28 28 28 28 28 28 28 28 28 28 28 43 43 43 43 43 43 43 43 36 37 37 37 37 37 37 37 37 37 37 37 37 38 28 28 61 61 61 61 61 61 61 61 61 61 61 61 61 61 61 61 61 61 61 61 61 61 61 61 49 34
34 34 49 28 28 7 36 37 37 37 38 8 28 28 28 28 28 28 28 28 28 28 28 28 28 28 28 28 28 28 43 43 43 43 43 43 43 43 28 28 61 61 61 61 61 61 61 61 61 61 61 61 28 28 61 61 61 61 61 61 61 28 61 61 61 61 61 61 61 61 61 61 61 61 61 28 61 61 49 34
34 34 49 28 28 49 49 49 49 49 49 49 28 28 28 28 28 28 28 28 28 28 28 28 28 28 28 28 28 28 43 43 43 43 43 43 43 43 28 61 61 61 61 61 61 61 61 61 61 61 61 28 28 28 61 61 61 61 61 61 61 61 61 61 61 61 61 61 61 61 61 61 61 61 61 61 61 28 49 34
34 34 49 28 28 28 28 28 28 28 28 28 28 28 28 28 28 28 28 28 28 28 28 28 28 28 28 28 28 28 43 43 43 43 28 43 43 43 28 28 61 61 61 28 28 28 28 28 28 28 28 28 28 28 61 61 61 28 28 28 28 28 28 61 61 61 28 28 28 28 28 28 28 28 28 28 28 28 49 34
34 34 49 28 28 28 28 28 28 28 28 28 28 28 28 28 28 28 28 28 28 28 28 28 28 28 28 28 43 43 43 43 43 43 43 43 43 43 61 61 61 61 61 61 61 61 61 61 61 61 28 28 28 28 61 61 61 28 28 28 28 28 28 28 61 61 61 61 61 61 61 61 61 28 28 28 28 28 49 34
34 34 49 28 28 28 28 28 28 28 28 28 28 28 49 49 49 49 28 28 49 49 49 49 49 49 49 28 43 43 43 43 28 43 43 28 28 61 61 61 61 61 61 61 61 61 61 61 61 61 61 28 28 28 61 61 28 28 28 28 28 28 28 28 61 61 61 61 61 61 61 61 61 61 28 28 28 28 49 34
34 34 49 28 73 73 73 73 73 73 73 73 73 28 7 54 56 49 28 28 49 54 55 55 55 56 49 28 43 28 43 43 43 43 43 43 43 43 28 28 61 61 61 61 61 61 61 61 61 61 61 28 28 28 61 61 61 61 61 61 28 28 28 61 61 61 61 61 61 61 61 61 61 61 61 28 28 28 49 34
34 34 49 28 28 73 73 73 73 73 73 73 28 28 7 72 74 49 28 28 49 20 28 28 28 18 49 28 43 28 43 43 43 43 0 1 1 1 1 1 1 1 1 1 1 1 1 1 1 2 61 28 28 28 61 61 61 61 61 61 61 28 61 61 61 61 61 61 61 61 61 61 61 61 61 28 28 61 49 34
34 34 49 28 28 73 73 73 73 73 73 73 28 28 7 72 74 49 28 28 49 20 28 28 28 18 49 28 43 28 43 43 43 43 18 19 19 19 19 19 19 19 19 19 19 19 19 19 19 20 28 28 28 61 61 61 61 61 61 61 61 61 28 61 61 61 61 61 61 61 61 61 61 61 61 28 28 28 49 34
34 34 49 28 28 73 73 73 73 73 73 73 28 28 7 72 74 49 49 49 49 90 91 91 91 92 49 28 43 43 43 43 43 43 18 19 19 19 19 19 19 19 19 19 19 19 19 19 19 20 28 28 28 28 61 61 61 61 61 61 61 61 61 61 61 61 61 61 61 61 61 61 61 61 28 28 28 28 49 34
34 34 49 28 28 73 73 73 73 73 73 73 73 28 49 72 74 54 55 55 55 56 49 49 49 49 49 28 43 43 43 43 43 43 18 19 19 19 19 19 19 19 19 19 19 19 19 19 19 20 28 28 28 28 61 61 61 61 61 61 61 61 61 61 61 61 61 61 61 61 61 61 61 61 61 28 61 61 49 34
34 34 49 28 28 28 28 28 28 28 28 28 28 28 49 72 74 72 28 28 28 74 49 28 28 28 28 28 43 43 28 43 43 43 18 19 19 19 19 19 19 19 19 19 19 19 19 19 19 20 28 28 28 61 61 61 61 61 61 61 61 61 61 61 61 61 61 61 61 61 61 61 61 61 61 61 61 61 49 34
34 34 49 28 28 28 28 28 28 28 28 28 28 28 49 72 74 72 28 28 28 74 49 73 73 28 28 28 43 43 43 43 43 43 18 19 19 19 19 19 19 19 19 19 19 19 19 19 19 20 28 28 28 61 49 49 49 49 49 49 49 49 49 49 49 49 49 49 49 49 49 49 49 49 49 49 49 49 49 34
34 34 49 28 28 28 28 28 28 28 28 28 28 28 49 90 92 90 91 91 91 92 49 73 73 73 28 28 43 43 43 43 43 43 18 19 19 19 19 19 19 19 19 19 19 19 19 19 19 20 28 28 28 61 7 28 28 28 28 28 28 28 28 28 108 109 109 109 109 109 109 109 109 110 28 28 28 28 49 34
34 34 49 28 28 49 49 49 49 49 49 49 28 28 49 49 49 49 49 49 49 49 49 73 73 73 28 28 28 43 43 43 43 43 18 19 19 19 19 19 19 19 19 19 19 19 19 19 19 20 28 28 28 61 49 49 49 49 49 49 49 28 28 28 126 19 19 19 19 19 19 19 19 128 28 28 28 49 49 34
34 34 49 28 28 49 34 34 34 34 34 49 28 28 28 73 73 73 73 73 73 73 73 73 73 73 28 28 28 28 43 43 43 43 18 19 19 19 19 19 19 19 19 19 19 19 19 19 19 20 28 28 28 61 49 34 34 34 34 34 49 28 28 28 126 19 19 19 19 19 19 19 19 128 28 28 28 49 34 34
34 34 49 28 28 49 34 34 34 34 34 49 28 28 28 73 73 73 73 73 73 73 73 73 73 73 28 28 28 28 43 43 43 43 36 37 37 37 37 37 37 37 37 37 37 37 37 37 37 38 28 28 28 28 49 34 34 34 34 34 49 28 28 28 126 19 19 19 19 19 19 19 19 128 28 28 28 49 34 34
34 34 49 28 28 49 34 34 34 34 34 49 28 28 49 49 49 49 49 49 49 49 49 49 49 49 49 49 28 28 43 43 43 43 43 43 28 28 28 28 61 61 61 61 61 61 61 61 61 61 28 28 28 28 49 34 34 34 34 34 49 28 28 28 126 19 19 19 19 19 19 19 19 128 28 28 28 49 34 34
34 34 49 28 28 49 49 49 49 49 49 49 28 28 49 28 28 28 28 28 28 28 28 28 28 28 28 49 28 43 43 43 43 43 43 43 28 28 28 28 61 61 61 61 61 61 61 61 61 61 61 28 28 28 49 49 49 49 49 49 49 28 28 28 144 145 145 145 145 145 145 145 145 146 28 28 28 49 49 34
34 34 49 28 28 28 28 28 28 28 28 28 28 28 49 28 28 49 49 49 49 49 49 49 49 28 28 49 28 28 28 28 28 28 28 28 28 28 28 28 28 28 28 28 28 28 28 28 28 28 28 28 28 28 49 28 28 28 28 28 28 97 97 97 97 97 97 97 97 97 97 97 97 97 28 28 28 28 49 34
34 34 49 28 28 28 28 28 28 28 28 28 28 28 49 28 28 49 34 34 34 34 34 34 49 28 28 49 28 28 28 28 28 28 28 28 28 28 28 28 28 28 28 28 28 28 28 28 28 28 28 28 28 61 49 97 97 97 97 97 97 97 28 97 97 97 97 97 97 97 97 97 97 97 97 28 28 28 49 34
34 34 49 28 28 28 28 28 28 28 28 28 28 28 49 28 28 49 34 49 49 49 49 34 49 28 28 49 28 28 28 28 28 28 28 28 28 28 28 28 28 28 28 28 28 28 28 28 28 28 28 28 28 61 49 97 97 97 97 97 97 28 97 0 91 91 91 91 91 91 91 91 91 91 2 28 28 28 49 34
34 34 49 28 28 28 28 28 28 28 28 28 28 28 49 28 28 49 34 49 34 34 49 34 49 28 28 49 28 28 28 28 28 28 28 28 28 28 28 49 49 49 49 49 49 49 49 49 49 49 28 28 28 61 49 97 97 97 97 97 97 97 97 74 49 49 49 49 49 49 49 49 49 49 72 28 28 28 49 34
34 34 49 28 28 28 28 28 28 28 28 28 28 28 49 28 28 49 34 49 34 34 49 34 49 28 28 49 28 28 28 28 28 28 28 28 28 28 28 49 34 34 34 34 34 34 34 34 34 49 28 28 28 61 49 28 97 97 97 97 97 97 97 74 49 34 34 34 34 34 34 34 34 49 72 28 28 28 49 34
34 34 49 28 28 28 28 28 28 28 28 28 28 28 49 28 28 49 34 49 34 34 49 34 49 28 28 49 28 28 49 49 49 49 49 49 28 28 28 49 34 34 34 34 34 34 34 34 34 49 28 28 28 61 49 97 97 97 97 97 28 97 97 74 49 34 34 34 34 34 34 34 34 49 72 28 28 28 49 34
34 34 49 28 28 28 28 28 28 28 28 28 28 28 7 28 28 49 34 49 34 34 49 34 49 28 28 8 28 28 49 34 34 34 34 49 28 28 28 49 34 34 34 34 34 34 34 34 34 49 28 28 28 73 49 97 97 97 97 97 28 97 97 74 49 34 34 34 34 34 34 34 34 49 20 28 28 28 49 34
34 34 49 49 49 49 49 49 49 49 49 49 49 49 49 49 49 49 34 49 50 50 49 34 49 49 49 49 49 49 49 34 34 34 34 49 49 49 49 49 34 34 34 34 34 34 34 34 34 49 49 49 49 49 49 49 49 49 49 49 49 49 49 49 49 34 34 34 34 34 34 34 34 49 49 49 49 49 49 34
34 34 34 34 34 34 34 34 34 34 34 34 34 34 34 34 34 34 34 34 34 34 34 34 34 34 34 34 34 34 34 34 34 34 34 34 34 34 34 34 34 34 34 34 34 34 34 34 34 34 34 34 34 34 34 34 34 34 34 34 34 34 34 34 34 34 34 34 34 34 34 34 34 34 34 34 34 34 34 34