80 80
34 34 34 34 34 34 34 34 34 34 34 34 34 34 34 34 34 34 34 34 34 34 34 34 34 34 34 34 34 34 34 34 34 34 34 34 34 34 34 34 34 34 34 34 34 34 34 34 34 34 34 34 34 34 34 34 34 34 34 34 34 34 34 34 34 34 34 34 34 34 34 34 34 34 34 34 34 34 34 34
34 34 34 34 34 34 34 34 34 34 34 34 34 34 34 34 34 34 34 34 34 34 34 34 34 34 34 34 34 34 34 34 34 34 34 34 34 34 34 34 34 34 34 34 34 34 34 34 34 34 34 34 34 34 34 34 34 34 34 34 34 34 34 34 34 34 34 34 34 34 34 34 34 34 34 34 34 34 34 34
34 34 49 49 49 49 49 49 49 49 49 49 49 49 49 49 49 49 49 49 49 49 49 49 49 49 49 49 49 49 49 49 49 49 49 49 49 49 49 49 49 49 49 49 49 49 49 49 49 49 49 49 49 49 49 49 49 49 49 49 49 49 49 49 49 49 49 49 49 49 49 49 49 49 49 49 49 49 49 34
34 34 49 61 61 61 61 61 61 61 61 61 61 61 61 61 61 73 73 73 73 73 73 73 28 28 28 28 28 28 28 28 28 28 28 28 28 28 28 9 10 10 10 10 10 10 10 10 10 10 11 28 28 28 28 28 28 28 28 28 28 28 28 28 28 28 28 28 28 28 28 28 28 28 28 28 28 28 49 34
34 34 49 61 61 61 61 61 61 61 61 61 61 61 61 61 61 73 73 73 73 73 73 73 61 61 28 28 28 9 10 10 10 10 10 11 28 28 28 27 0 1 1 1 1 1 1 1 1 2 32 28 28 28 28 28 28 28 28 28 28 28 28 28 28 28 28 28 28 28 28 28 28 28 28 28 28 28 49 34
34 34 49 61 28 9 10 10 10 10 10 11 61 61 61 61 61 73 73 73 73 73 73 73 61 61 28 28 28 27 0 1 1 1 2 14 28 28 28 27 18 19 19 19 19 19 19 19 19 20 32 28 28 28 28 28 28 28 28 28 28 28 28 28 28 28 28 28 28 28 28 28 28 28 28 28 28 28 49 34
34 34 49 61 28 31 22 22 22 22 22 32 61 61 61 61 73 73 73 73 73 73 73 73 73 61 28 28 28 27 18 19 19 19 20 14 28 28 28 27 18 19 19 19 19 19 19 19 19 20 32 28 28 28 28 28 28 28 28 28 28 28 28 28 28 28 28 28 28 28 28 28 28 28 28 28 28 28 49 34
34 34 49 61 28 31 22 22 22 22 22 32 61 61 61 61 61 73 73 73 73 73 73 73 73 61 28 28 28 27 18 19 19 19 20 14 28 28 28 27 18 19 19 19 19 19 19 19 19 20 32 28 28 28 28 28 28 28 28 28 28 28 28 28 28 28 28 28 28 28 28 28 28 28 28 28 28 28 49 34
34 34 49 61 28 31 22 22 22 22 22 32 61 61 61 61 61 73 73 73 73 73 73 73 61 61 28 28 28 27 18 19 19 19 20 14 28 28 28 27 18 19 19 19 19 19 19 19 19 20 32 28 28 28 28 28 28 28 28 28 28 28 28 28 28 28 28 28 28 28 28 28 28 28 28 28 28 28 49 34
34 34 49 61 61 31 22 22 22 22 22 32 61 61 61 61 61 73 73 73 73 73 73 73 61 61 28 28 28 27 18 19 19 19 20 14 28 28 28 27 18 19 19 19 19 19 19 19 19 20 32 28 28 28 28 28 28 28 28 28 28 28 28 28 28 28 28 28 28 28 28 28 28 28 28 28 28 28 49 34
34 34 49 28 61 31 22 22 22 22 22 32 169 61 61 61 61 73 73 73 73 73 73 73 61 61 28 28 28 27 18 19 19 19 20 28 10 10 10 28 18 19 19 19 19 19 19 19 19 20 32 28 28 28 28 81 82 82 82 82 82 82 82 82 82 82 82 82 82 82 82 82 82 82 83 28 28 28 49 34
34 34 49 28 61 31 22 22 22 22 22 32 61 61 61 61 73 73 73 73 73 73 73 73 61 61 28 28 28 27 18 19 19 19 20 28 28 28 28 28 18 19 19 19 19 19 19 19 19 20 32 28 28 28 28 81 34 34 34 34 34 34 34 34 34 34 34 34 34 34 34 34 34 34 83 28 28 28 49 34
34 34 49 28 61 45 118 118 118 118 118 47 61 61 61 61 61 73 73 73 73 73 73 73 73 73 73 73 73 27 36 37 37 37 38 28 28 28 28 28 36 37 37 37 37 37 37 37 37 38 32 28 28 28 28 81 34 81 82 82 82 82 82 82 82 82 82 82 82 82 82 82 83 34 83 28 28 28 49 34
34 34 49 28 61 61 61 61 61 61 61 61 28 61 61 61 61 61 61 61 61 61 61 61 28 28 28 28 28 27 28 28 28 28 28 28 28 28 28 28 28 28 28 28 28 28 28 28 28 28 32 28 28 28 28 81 34 81 34 34 34 34 34 34 34 34 34 34 34 34 34 34 83 34 83 28 28 28 49 34
34 34 49 28 61 61 61 61 61 61 61 61 28 61 28 28 28 113 113 113 113 113 113 113 28 28 28 28 28 27 28 28 28 28 28 28 28 28 28 28 28 28 28 28 28 28 28 28 28 28 32 28 28 28 28 81 34 81 34 81 82 82 82 82 82 82 82 82 82 82 83 34 83 34 83 28 28 28 49 34
34 34 49 28 28 28 28 28 28 28 28 28 28 61 28 28 113 82 82 82 82 82 82 82 82 113 28 28 28 27 28 28 28 28 28 28 28 46 46 28 0 1 1 1 1 1 1 1 1 2 32 28 28 28 28 81 34 81 34 81 34 34 34 34 34 34 34 34 34 34 83 34 83 34 83 28 28 28 49 34
34 34 49 28 28 108 109 109 109 109 109 110 28 28 28 28 113 82 34 34 34 34 34 34 82 113 28 28 28 27 0 1 1 1 1 2 32 28 28 27 18 19 19 19 19 19 19 19 19 20 32 28 28 28 28 81 34 81 34 99 100 100 100 100 100 100 100 100 100 100 101 34 83 34 83 28 28 28 49 34
34 34 49 28 28 126 3 4 4 4 5 128 28 28 28 28 113 82 34 34 34 34 34 34 82 113 28 28 28 27 18 19 19 19 19 20 32 28 28 27 18 19 19 19 19 19 19 19 19 20 32 28 28 28 28 81 34 81 34 34 34 34 34 34 34 34 34 34 34 34 34 34 83 34 83 28 28 28 49 34
34 34 49 28 28 126 21 28 28 28 23 128 28 28 28 28 113 82 34 34 34 34 34 34 82 113 28 28 28 27 18 19 19 19 19 20 32 28 28 27 18 19 19 19 19 19 19 19 19 20 32 28 28 28 28 81 34 99 100 100 100 100 100 100 100 100 100 100 100 100 100 100 83 34 83 28 28 28 49 34
34 34 49 28 28 7 28 28 28 28 28 8 28 28 28 28 113 82 34 34 34 34 34 34 82 113 28 28 28 27 18 19 19 19 19 20 32 28 28 27 18 19 19 19 19 19 19 19 19 20 32 28 28 28 28 81 34 34 34 34 34 34 34 34 34 34 34 34 34 34 34 34 34 34 83 28 28 28 49 34
34 34 49 28 28 126 21 28 28 28 23 128 28 28 28 28 113 82 34 34 34 34 34 34 82 113 28 28 28 27 18 19 19 19 19 20 32 28 28 27 18 19 19 19 19 19 19 19 19 20 32 28 28 28 28 99 100 100 100 100 100 100 100 100 100 100 100 100 100 100 100 100 100 100 101 28 28 28 49 34
34 34 49 28 28 126 39 40 40 40 41 128 28 28 28 97 113 82 34 34 34 34 34 34 82 113 28 28 28 27 18 19 19 19 19 20 32 28 28 27 18 19 19 19 19 19 19 19 19 20 32 28 28 28 28 28 28 28 28 28 28 28 28 28 28 28 28 28 28 28 28 28 28 28 28 28 28 28 49 34
34 34 49 28 28 144 145 145 145 145 145 146 28 28 28 28 113 100 100 100 100 100 100 100 100 113 28 28 28 27 36 37 37 37 37 38 32 28 28 27 36 37 37 37 37 37 37 37 37 38 32 28 28 28 28 28 28 28 28 28 28 28 28 28 28 28 28 28 28 28 28 28 28 28 28 28 28 28 49 34
34 34 49 28 28 28 28 28 28 28 28 28 28 28 28 28 28 28 28 28 28 28 28 28 28 113 28 28 28 45 46 46 46 46 46 46 47 28 28 45 46 46 46 46 46 46 46 46 46 46 47 28 28 28 28 28 28 28 28 28 28 28 28 28 28 28 28 28 28 28 28 28 28 28 28 28 28 28 49 34
34 34 49 28 28 28 28 28 28 28 28 28 28 28 28 28 28 61 61 61 61 61 61 61 28 28 28 28 28 28 28 28 28 28 28 28 28 28 28 28 28 28 28 28 28 28 28 28 28 28 28 28 28 28 28 28 28 28 28 28 28 28 28 28 108 109 109 109 109 109 109 109 109 110 28 28 28 28 49 34
34 34 49 28 28 73 73 73 73 73 28 28 28 28 28 28 73 73 73 73 73 73 73 73 73 73 73 28 28 28 28 28 28 28 28 28 28 28 28 28 28 28 28 28 28 28 28 28 28 28 28 28 28 28 28 28 28 28 28 28 28 28 28 28 126 19 19 19 19 19 19 19 19 128 28 28 28 28 49 34
34 34 49 28 28 73 73 73 73 73 28 28 28 28 28 28 73 73 73 73 73 73 73 73 73 73 28 28 28 108 109 109 109 109 109 110 28 28 28 28 28 28 28 28 28 28 28 28 28 28 28 28 28 28 28 28 28 28 28 28 28 28 28 28 126 19 19 19 19 19 19 19 19 128 28 28 28 28 49 34
34 34 49 28 28 73 73 73 73 28 28 28 28 28 28 28 73 73 73 73 73 73 73 73 73 73 28 28 28 126 81 82 82 82 83 128 28 28 28 28 28 28 28 28 28 28 28 28 28 28 28 28 28 28 28 28 28 28 28 28 28 28 28 28 126 19 19 19 19 19 19 19 19 128 28 28 28 28 49 34
34 34 49 28 28 73 73 73 73 28 28 28 28 28 28 28 73 73 73 73 73 73 73 73 73 73 28 28 28 126 81 54 55 56 83 128 28 28 28 28 9 10 10 10 10 10 10 10 10 10 10 10 10 10 11 28 28 28 28 28 28 28 28 28 126 19 19 19 19 19 19 19 19 128 28 28 28 28 49 34
34 34 49 28 28 73 73 73 73 28 28 28 28 28 28 28 73 73 73 73 73 73 73 73 73 73 28 28 28 126 81 72 73 74 83 128 28 28 28 28 27 0 1 1 1 1 1 1 1 1 1 1 1 2 32 28 28 28 28 28 28 28 28 28 126 19 19 19 19 19 19 19 19 128 28 28 28 28 49 34
34 34 49 28 28 73 73 73 73 28 28 28 28 28 28 28 73 73 73 73 73 73 73 73 73 73 28 28 28 126 81 72 73 74 83 128 79 28 28 28 27 18 19 19 19 19 19 19 19 19 19 19 19 20 32 28 28 28 28 28 28 28 28 28 126 19 19 19 19 19 19 19 19 128 28 28 28 28 49 34
34 34 49 28 28 73 73 73 73 28 28 28 28 28 28 28 73 73 73 73 73 73 73 73 73 73 28 28 28 126 81 72 73 74 83 128 79 28 28 28 27 18 19 19 54 55 55 55 55 55 56 19 19 20 32 28 28 28 28 28 28 28 28 28 126 19 19 19 19 19 19 19 19 128 28 28 28 28 49 34
34 34 49 28 28 73 73 73 73 28 28 28 28 28 28 28 73 73 73 73 73 73 73 73 73 73 28 28 28 126 81 72 73 74 83 128 79 28 28 28 7 18 19 19 72 97 97 97 97 97 74 19 19 20 8 28 28 28 28 28 28 28 28 28 126 19 19 19 19 19 19 19 19 128 28 28 28 28 49 34
34 34 49 28 28 73 73 73 73 28 28 28 28 28 28 28 28 28 28 28 28 28 28 28 28 28 28 28 28 7 61 61 61 61 61 8 79 28 28 28 7 18 19 19 90 91 91 91 91 91 92 19 19 20 8 28 28 28 28 28 28 28 28 28 126 19 19 19 19 19 19 19 19 128 28 28 28 28 49 34
34 34 49 28 28 73 73 73 73 28 28 28 28 28 28 28 9 10 10 10 10 10 10 10 10 11 28 28 28 7 61 61 61 61 61 8 28 28 28 28 27 18 19 19 19 19 19 19 19 19 19 19 19 20 32 28 28 28 28 28 28 28 28 28 126 19 19 19 19 19 19 19 19 128 28 28 28 28 49 34
34 34 49 28 28 73 73 73 73 28 28 28 28 28 28 28 27 0 1 1 1 1 1 1 2 14 28 28 28 7 61 61 61 61 61 8 28 28 28 28 27 36 37 37 37 37 37 37 37 37 37 37 37 38 32 28 28 28 28 28 28 28 28 28 126 19 19 19 19 19 19 19 19 128 28 28 28 28 49 34
34 34 49 28 28 3 4 4 4 4 4 5 28 28 28 28 7 18 127 127 127 127 127 127 20 8 28 28 28 126 81 72 73 74 83 128 28 28 28 28 27 28 28 28 136 25 25 25 25 25 28 28 28 28 32 28 28 28 28 28 28 28 28 28 126 19 19 19 19 19 19 19 19 128 28 28 28 28 49 34
34 34 49 28 28 21 81 82 82 82 83 23 28 28 28 28 7 18 127 127 127 127 127 127 20 8 28 28 28 126 81 72 73 74 83 128 28 28 28 28 45 46 46 46 47 28 28 28 28 28 45 46 46 46 47 28 28 28 28 28 28 28 28 28 126 19 19 19 19 19 19 19 19 128 28 28 28 28 49 34
34 34 49 28 28 21 81 34 34 34 83 23 28 28 28 28 7 18 127 127 127 127 127 127 20 8 28 28 28 126 81 72 73 74 83 128 28 28 28 28 28 28 28 28 28 28 28 28 28 28 28 28 28 28 28 28 28 28 28 28 28 28 28 28 126 19 19 19 19 19 19 19 19 128 28 28 28 28 49 34
34 34 49 28 28 21 99 100 100 100 101 23 28 28 28 28 27 36 37 37 37 37 37 37 38 14 28 28 28 126 81 90 91 92 83 128 28 28 28 28 28 28 28 28 28 28 28 28 28 28 28 28 28 28 28 28 28 28 28 28 28 28 28 28 126 19 19 19 19 19 19 19 19 128 28 28 28 28 49 34
34 34 49 28 28 39 40 40 40 40 40 41 28 28 28 28 45 46 46 46 46 46 46 46 46 47 28 28 28 126 99 100 100 100 101 128 28 28 0 1 1 1 1 1 1 1 1 1 1 1 1 2 28 28 28 28 28 28 28 28 28 28 28 28 126 19 19 19 19 19 19 19 19 128 28 28 28 28 49 34
34 34 49 28 28 28 28 28 28 28 28 28 28 28 28 28 28 28 28 28 28 28 28 28 28 28 28 28 28 144 145 145 145 145 145 146 28 28 18 81 82 82 82 82 82 82 82 82 82 82 83 20 28 28 28 28 28 28 28 28 28 28 28 28 126 19 19 19 19 19 19 19 19 128 28 28 28 28 49 34
34 34 49 28 28 28 28 28 28 28 28 28 28 28 28 28 73 73 73 73 73 28 73 73 73 73 62 28 28 28 28 28 28 28 28 28 28 28 18 81 34 34 34 34 34 34 34 34 34 34 83 20 28 28 28 28 28 28 28 28 28 28 28 28 126 19 19 19 19 19 19 19 19 128 28 28 28 28 49 34
34 34 49 28 28 28 28 28 28 28 28 28 28 9 10 10 10 10 10 10 10 11 73 73 73 73 28 28 28 28 28 28 28 28 28 28 28 28 18 81 34 34 34 34 34 34 34 34 34 34 83 20 28 28 28 28 28 28 28 28 28 28 28 28 126 19 19 19 19 19 19 19 19 128 28 28 28 28 49 34
34 34 49 28 28 73 73 73 73 73 73 73 28 27 9 10 10 10 10 11 43 14 43 43 73 43 43 43 43 28 43 43 43 43 43 43 28 28 18 81 34 34 34 34 34 34 34 34 34 34 83 20 28 28 28 28 28 28 28 28 28 28 28 28 126 19 19 19 19 19 19 19 19 128 28 28 28 28 49 34
34 34 49 28 28 73 73 73 73 73 73 73 28 7 7 28 127 127 127 29 73 14 43 43 43 43 43 43 43 43 43 43 43 43 43 43 43 43 18 81 34 34 34 34 34 34 34 34 34 34 83 20 28 28 28 28 28 28 28 28 28 28 28 28 126 19 19 19 19 19 19 19 19 128 28 28 28 28 49 34
34 34 49 28 28 73 73 73 73 73 73 73 28 7 7 28 127 127 127 29 73 43 10 10 10 10 10 10 11 43 43 43 43 43 43 43 28 28 18 81 34 34 34 34 34 34 34 34 34 34 83 20 28 28 28 28 28 28 28 28 28 28 28 28 126 19 19 19 19 19 19 19 19 128 28 28 28 28 49 34
34 34 49 28 28 73 73 73 73 73 73 73 28 7 7 28 127 127 127 73 10 10 10 10 10 10 10 11 32 43 43 43 43 43 43 43 43 43 18 81 34 34 34 34 34 34 34 34 34 34 83 20 28 28 28 28 28 28 28 28 28 28 28 28 126 19 19 19 19 19 19 19 19 128 28 28 28 28 49 34
34 34 49 28 28 73 73 73 73 73 73 73 28 27 45 46 46 46 46 46 46 46 73 127 127 127 127 29 32 28 43 43 43 43 43 43 43 43 18 81 34 34 34 34 34 34 34 34 34 34 83 20 28 28 28 28 28 28 28 28 28 28 28 28 144 145 145 145 145 145 145 145 145 146 28 28 28 28 49 34
34 34 49 28 28 28 28 28 28 28 28 28 28 27 28 28 28 28 28 28 28 28 27 127 127 127 127 29 32 28 28 28 28 43 43 43 43 43 18 81 34 34 34 34 34 34 34 34 34 34 83 20 28 28 28 28 28 28 28 28 28 28 28 28 28 28 28 28 28 28 28 28 28 28 28 28 28 28 49 34
34 34 49 28 28 28 28 28 28 28 28 28 28 45 46 46 46 46 46 46 46 28 45 46 118 118 46 47 32 28 28 28 43 43 28 43 43 43 18 81 34 34 34 34 34 34 34 34 34 34 83 20 28 28 28 28 28 28 28 28 28 28 28 28 28 28 28 28 28 28 28 28 28 28 28 28 28 28 49 34
34 34 49 28 28 9 10 10 10 10 10 11 28 28 28 28 28 28 28 28 28 45 46 46 118 118 46 46 47 28 43 43 43 43 43 43 43 43 18 99 100 100 100 100 49 49 100 100 100 100 101 20 28 28 61 61 61 61 61 61 61 61 28 61 61 61 61 61 61 61 61 61 61 61 61 61 61 61 49 34
34 34 49 28 28 7 0 1 1 1 2 8 28 28 28 28 28 28 28 28 28 28 28 28 28 28 28 28 28 28 43 43 43 43 43 43 43 43 36 37 37 37 37 37 37 37 37 37 37 37 37 38 28 28 61 61 61 61 61 61 61 61 61 61 61 61 61 61 61 61 61 61 61 61 61 61 61 61 49 34
34 34 49 28 28 7 36 37 37 37 38 8 28 28 28 28 28 28 28 28 28 28 28 28 28 28 28 28 28 28 43 43 43 43 43 43 43 43 28 28 61 61 61 61 61 61 61 61 61 61 61 61 28 28 61 61 61 61 61 61 61 28 61 61 61 61 61 61 61 61 61 61 61 61 61 28 61 61 49 34
34 34 49 28 28 45 46 46 46 46 46 47 28 28 28 28 28 28 28 28 28 28 28 28 28 28 28 28 28 28 43 43 43 43 43 43 43 43 28 61 61 61 61 61 61 61 61 61 61 61 61 28 28 28 61 61 61 61 61 61 61 61 61 61 61 61 61 61 61 61 61 61 61 61 61 61 61 28 49 34
34 34 49 28 28 28 28 28 28 28 28 28 28 28 28 28 28 28 28 28 28 28 28 28 28 28 28 28 28 28 43 43 43 43 28 43 43 43 28 28 61 61 61 28 28 28 28 28 28 28 28 28 28 28 61 61 61 28 28 28 28 28 28 61 61 61 28 28 28 28 28 28 28 28 28 28 28 28 49 34
34 34 49 28 28 28 28 28 28 28 28 28 28 28 28 28 28 28 28 28 28 28 28 28 28 28 28 28 43 43 43 43 43 43 43 43 43 43 61 61 61 61 61 61 61 61 61 61 61 61 28 28 28 28 61 61 61 28 28 28 28 28 28 28 61 61 61 61 61 61 61 61 61 28 28 28 28 28 49 34
34 34 49 28 28 28 28 28 28 28 28 28 28 28 9 10 10 11 28 28 9 10 10 10 10 10 11 28 43 43 43 43 28 43 43 28 28 61 61 61 61 61 61 61 61 61 61 61 61 61 61 28 28 28 61 61 28 28 28 28 28 28 28 28 61 61 61 61 61 61 61 61 61 61 28 28 28 28 49 34
34 34 49 28 73 73 73 73 73 73 73 73 73 28 7 54 56 14 28 28 27 54 55 55 55 56 29 28 43 28 43 43 43 43 43 43 43 43 28 28 61 61 61 61 61 61 61 61 61 61 61 28 28 28 61 61 61 61 61 61 28 28 28 61 61 61 61 61 61 61 61 61 61 61 61 28 28 28 49 34
34 34 49 28 28 73 73 73 73 73 73 73 28 28 7 72 74 14 28 28 27 20 28 28 28 18 29 28 43 28 43 43 43 43 0 1 1 1 1 1 1 1 1 1 1 1 1 1 1 2 61 28 28 28 61 61 61 61 61 61 61 28 61 61 61 61 61 61 61 61 61 61 61 61 61 28 28 61 49 34
34 34 49 28 28 73 73 73 73 73 73 73 28 28 7 72 74 14 28 28 27 20 28 28 28 18 29 28 43 28 43 43 43 43 18 19 19 19 19 19 19 19 19 19 19 19 19 19 19 20 28 28 28 61 61 61 61 61 61 61 61 61 28 61 61 61 61 61 61 61 61 61 61 61 61 28 28 28 49 34
34 34 49 28 28 73 73 73 73 73 73 73 28 28 7 72 74 28 10 10 28 90 91 91 91 92 29 28 43 43 43 43 43 43 18 19 19 19 19 19 19 19 19 19 19 19 19 19 19 20 28 28 28 28 61 61 61 61 61 61 61 61 61 61 61 61 61 61 61 61 61 61 61 61 28 28 28 28 49 34
34 34 49 28 28 73 73 73 73 73 73 73 73 28 27 72 79 55 55 55 55 56 28 46 46 46 47 28 43 43 43 43 43 43 18 19 19 19 19 19 19 19 19 19 19 19 19 19 19 20 28 28 28 28 61 61 61 61 61 61 61 61 61 61 61 61 61 61 61 61 61 61 61 61 61 28 61 61 49 34
34 34 49 28 28 28 28 28 28 28 28 28 28 28 27 72 79 28 28 28 79 74 32 28 28 28 28 28 43 43 28 43 43 43 18 19 19 19 19 19 19 19 19 19 19 19 19 19 19 20 28 28 28 61 61 61 61 61 61 61 61 61 61 61 61 61 61 61 61 61 61 61 61 61 61 61 61 61 49 34
34 34 49 28 28 28 28 28 28 28 28 28 28 28 27 72 79 79 79 79 79 74 32 73 73 28 28 28 43 43 43 43 43 43 18 19 19 19 19 19 19 19 19 19 19 19 19 19 19 20 28 28 28 61 9 10 10 10 10 10 10 10 10 10 10 10 10 10 10 10 10 10 10 10 10 10 10 10 49 34
34 34 49 28 28 28 28 28 28 28 28 28 28 28 27 90 91 91 91 91 91 92 32 73 73 73 28 28 43 43 43 43 43 43 18 19 19 19 19 19 19 19 19 19 19 19 19 19 19 20 28 28 28 61 27 28 28 28 28 28 28 28 28 28 108 109 109 109 109 109 109 109 109 110 28 28 28 28 49 34
34 34 49 28 28 81 75 82 82 82 82 83 28 28 45 46 46 46 46 46 46 46 47 73 73 73 28 28 28 43 43 43 43 43 18 19 19 19 19 19 19 19 19 19 19 19 19 19 19 20 28 28 28 61 27 81 82 82 82 82 83 28 28 28 126 19 19 19 19 19 19 19 19 128 28 28 28 81 82 34
34 34 49 28 28 81 34 34 34 34 34 83 28 28 28 73 73 73 73 73 73 73 73 73 73 73 28 28 28 28 43 43 43 43 18 19 19 19 19 19 19 19 19 19 19 19 19 19 19 20 28 28 28 61 27 81 34 34 34 34 83 28 28 28 126 19 19 19 19 19 19 19 19 128 28 28 28 81 34 34
34 34 49 28 28 81 34 34 34 34 34 83 28 28 28 73 73 73 73 73 73 73 73 73 73 73 28 28 28 28 43 43 43 43 36 37 37 37 37 37 37 37 37 37 37 37 37 37 37 38 28 28 28 28 27 81 34 34 34 34 83 28 28 28 126 19 19 19 19 19 19 19 19 128 28 28 28 81 34 34
34 34 49 28 28 81 34 34 34 34 34 83 28 28 9 10 10 10 10 10 10 10 10 10 10 10 10 11 28 28 43 43 43 43 43 43 28 28 28 28 61 61 61 61 61 61 61 61 61 61 28 28 28 28 27 81 34 34 34 34 83 28 28 28 126 19 19 19 19 19 19 19 19 128 28 28 28 81 34 34
34 34 49 28 28 99 100 100 100 100 100 101 28 28 27 28 108 109 109 109 109 109 109 109 109 110 28 32 28 43 43 43 43 43 43 43 28 28 28 28 61 61 61 61 61 61 61 61 61 61 61 28 28 28 27 99 100 100 100 100 101 28 28 28 144 145 145 145 145 145 145 145 145 146 28 28 28 99 49 34
34 34 49 28 28 28 28 28 28 28 28 28 28 28 27 28 126 81 94 94 94 94 94 94 83 128 28 32 28 28 28 28 28 28 28 28 28 28 28 28 28 28 28 28 28 28 28 28 28 28 28 28 28 28 27 28 28 28 28 28 28 97 97 97 97 97 97 97 97 97 97 97 97 97 28 28 28 28 49 34
34 34 49 28 28 28 28 28 28 28 28 28 28 28 27 28 126 81 34 34 34 34 34 34 83 128 28 32 28 28 28 28 28 28 28 28 28 28 28 28 28 28 28 28 28 28 28 28 28 28 28 28 28 61 27 97 97 97 97 97 97 97 28 97 97 97 97 97 97 97 97 97 97 97 97 28 28 28 49 34
34 34 49 28 28 28 28 28 28 28 28 28 28 28 27 28 126 81 34 49 49 49 49 34 83 128 28 32 28 28 28 28 28 28 28 28 28 28 28 28 28 28 28 28 28 28 28 28 28 28 28 28 28 61 27 97 97 97 97 97 97 28 97 28 91 91 91 91 91 91 91 91 91 91 28 28 28 28 49 34
34 34 49 28 28 28 28 28 28 28 28 28 28 28 27 28 126 81 34 49 34 34 49 34 83 128 28 32 28 28 28 28 28 28 28 28 28 28 28 49 49 49 49 49 49 49 49 49 49 49 28 28 28 61 27 97 97 97 97 97 97 97 97 74 81 82 82 82 82 82 82 82 82 83 72 28 28 28 49 34
34 34 49 28 28 28 28 28 28 28 28 28 28 28 27 28 126 81 34 49 34 34 49 34 83 128 28 32 28 28 28 28 28 28 28 28 28 28 28 49 34 34 34 34 34 34 34 34 34 49 28 28 28 61 27 28 97 97 97 97 97 97 97 74 81 34 34 34 34 34 34 34 34 83 72 28 28 28 49 34
34 34 49 28 28 54 55 55 55 55 55 56 28 28 27 28 126 81 34 49 34 34 49 34 83 128 28 32 28 28 49 49 49 49 49 49 28 28 28 49 34 34 34 34 34 34 34 34 34 49 28 28 28 61 27 97 97 97 97 97 28 97 97 74 81 34 34 34 34 34 34 34 34 83 72 28 28 28 49 34
34 34 49 28 28 72 9 10 10 10 11 74 28 28 27 28 126 81 34 49 34 34 49 34 83 128 28 32 28 28 49 34 34 34 34 49 28 28 28 49 34 34 34 34 34 34 34 34 34 49 28 28 28 73 27 97 97 97 97 97 28 97 97 74 81 34 34 34 34 34 34 34 34 83 72 28 28 28 49 34
34 34 49 49 49 49 49 49 49 49 49 49 49 49 49 49 49 49 34 49 50 50 49 34 49 49 49 49 49 49 49 34 34 34 34 49 49 49 49 49 34 34 34 34 34 34 34 34 34 49 49 49 49 49 49 49 49 49 49 49 49 49 49 49 81 34 34 34 34 34 34 34 34 83 49 49 49 49 49 34
34 34 34 34 34 34 34 34 34 34 34 34 34 34 34 34 34 34 34 34 34 34 34 34 34 34 34 34 34 34 34 34 34 34 34 34 34 34 34 34 34 34 34 34 34 34 34 34 34 34 34 34 34 34 34 34 34 34 34 34 34 34 34 34 34 34 34 34 34 34 34 34 34 34 34 34 34 34 34 34