40 30
19 34 36 36 36 36 36 36 36 36 36 36 36 36 36 36 36 36 36 36 36 36 36 36 36 36 36 36 36 36 36 36 36 36 36 36 36 36 36 37
27 20 20 19 20 20 20 19 20 19 20 20 20 20 19 20 20 19 20 20 20 20 19 20 19 20 20 19 20 19 20 20 19 20 19 20 20 19 20 19
27 37 20 27 20 19 20 27 20 27 20 34 37 20 27 20 20 27 20 34 37 20 27 20 27 20 20 27 20 27 20 20 27 20 27 20 20 27 20 27
27 20 20 43 20 27 20 27 20 43 20 20 20 20 27 20 20 43 20 19 20 20 43 20 27 20 20 43 20 27 20 20 43 20 27 20 20 43 20 27
27 20 34 37 20 27 20 27 20 34 36 36 37 20 27 20 34 37 20 27 20 34 37 20 43 20 34 37 20 27 20 34 37 20 43 20 34 37 20 27
27 20 20 20 20 27 20 43 20 20 20 20 20 20 27 20 20 20 20 43 20 20 20 20 20 20 20 20 20 43 20 20 20 20 20 20 20 20 20 27
27 34 36 37 20 27 20 34 36 36 36 36 37 20 27 34 36 37 20 34 36 36 36 37 19 34 36 36 36 36 36 36 37 20 19 34 36 37 20 27
27 20 20 20 20 43 20 20 20 20 20 20 20 20 27 20 20 20 20 20 20 20 20 20 27 20 20 20 20 20 20 20 20 20 27 20 20 20 20 27
27 20 34 36 36 36 36 36 36 36 36 36 37 20 43 20 34 36 36 36 36 36 36 37 43 20 34 36 36 36 36 36 36 37 43 20 34 37 20 27
27 20 20 20 20 20 20 20 20 20 20 20 20 20 20 20 19 20 20 20 20 20 20 20 20 20 19 20 20 20 20 20 20 20 20 20 34 37 20 27
27 20 20 20 19 34 36 36 36 36 36 36 36 36 37 20 27 20 34 36 36 36 36 36 37 20 27 20 34 36 36 36 36 36 37 20 34 37 20 27
27 20 19 20 27 20 20 20 20 20 20 20 20 20 20 20 43 20 19 20 20 20 20 20 20 20 43 20 19 20 20 20 20 20 20 20 34 37 20 27
27 20 27 20 27 20 34 36 36 36 36 36 36 36 36 36 37 20 27 20 34 36 36 36 36 36 37 20 27 20 34 36 36 36 36 36 36 37 20 27
27 20 27 20 27 20 19 20 20 20 20 20 20 20 20 20 20 20 27 20 27 20 20 20 20 20 20 20 43 20 19 20 20 20 20 20 20 20 20 27
27 20 27 20 43 20 27 20 34 36 36 36 36 36 36 36 37 20 43 20 27 20 34 36 36 36 36 36 37 20 27 20 34 36 36 36 37 19 20 27
27 20 43 20 20 20 27 20 20 20 20 20 20 20 20 20 20 20 20 20 27 20 20 20 20 20 20 20 20 20 43 20 19 20 20 20 20 27 20 27
27 20 34 37 19 20 27 20 19 20 34 36 37 20 34 36 36 36 36 36 36 20 19 20 34 36 36 36 36 36 37 20 27 20 34 36 37 43 20 27
27 20 20 20 27 20 27 20 27 20 19 20 20 20 20 20 20 20 20 20 20 20 27 20 19 20 20 20 20 20 20 20 43 20 19 20 19 19 20 27
27 19 27 20 27 20 43 20 27 20 27 20 34 36 36 36 36 36 36 36 36 37 43 20 27 20 34 36 36 36 36 36 37 20 27 20 27 27 20 27
27 27 27 20 43 20 20 20 27 20 27 20 19 20 20 20 20 20 20 20 20 20 20 20 43 20 19 20 20 20 20 20 20 20 43 20 27 27 20 27
27 27 27 20 20 20 19 20 27 20 27 20 27 20 34 37 20 34 36 36 36 36 36 36 37 20 27 20 34 36 36 36 36 36 37 20 27 27 20 27
27 27 27 19 19 20 27 20 27 20 27 20 43 20 19 20 20 20 20 20 20 20 20 20 20 20 43 20 19 20 20 20 20 20 20 20 43 43 20 27
27 27 27 27 34 36 37 20 27 20 43 20 20 20 27 34 36 36 36 36 37 20 34 36 36 36 37 20 43 20 34 36 36 36 36 36 36 37 20 27
27 27 27 27 34 36 37 20 27 20 20 20 19 20 27 20 19 20 20 20 20 20 20 20 20 20 20 20 43 20 19 20 20 20 20 20 20 20 20 27
27 27 27 27 19 20 19 20 27 20 19 20 27 20 27 20 27 20 34 36 36 36 36 36 36 36 36 36 37 20 27 20 34 36 36 36 36 37 20 27
27 27 27 27 27 20 27 34 37 20 27 20 27 20 27 20 27 20 27 20 20 20 20 20 20 20 20 20 20 20 43 20 19 20 20 20 20 20 20 27
27 43 43 43 43 20 43 20 27 20 43 20 43 20 27 20 27 20 34 36 36 37 20 19 34 36 36 36 36 36 37 20 27 20 20 20 20 20 20 27
27 20 20 20 20 20 20 20 43 34 36 36 37 20 43 20 43 20 20 20 20 20 20 43 20 20 20 20 20 20 20 20 43 20 20 20 20 20 20 27
27 20 20 20 20 20 20 20 20 20 20 20 20 20 20 20 20 20 34 36 36 36 36 36 36 36 36 36 36 36 36 36 36 20 20 20 20 20 20 27
43 34 36 36 36 36 36 36 36 36 36 36 36 36 36 36 36 36 36 36 36 36 36 36 36 36 36 36 36 36 36 36 36 36 36 36 36 36 36 37